"aa" = (/turf/template_noop,/area/template_noop)
"ab" = (/turf/closed/wall/r_wall,/area/ruin/powered)
"ac" = (/obj/machinery/door/airlock/external,/turf/open/floor/plating,/area/ruin/powered)
"ad" = (/obj/machinery/light{dir = 8; light_color = "#e8eaff"},/turf/open/floor/plasteel,/area/ruin/powered)
"ae" = (/turf/open/floor/plasteel,/area/ruin/powered)
"af" = (/obj/structure/chair/office/light{dir = 4},/obj/machinery/button/door{id = "lablockdown1"; name = "Labs Lockdown"; pixel_y = 25},/turf/open/floor/plasteel,/area/ruin/powered)
"ag" = (/obj/structure/table/reinforced,/obj/machinery/door/window/eastleft,/obj/machinery/flasher{id = "researchbunkerflash1"; pixel_y = 25},/obj/machinery/door/window/westleft,/turf/open/floor/plating,/area/ruin/powered)
"ah" = (/turf/open/floor/plating,/area/ruin/powered)
"ai" = (/obj/machinery/light{dir = 4; light_color = "#e8eaff"},/turf/open/floor/plating,/area/ruin/powered)
"aj" = (/obj/machinery/vending/cola/random,/turf/open/floor/plasteel/barber,/area/ruin/powered)
"ak" = (/obj/machinery/vending/snack/blue,/turf/open/floor/plasteel/barber,/area/ruin/powered)
"al" = (/obj/machinery/vending/cigarette,/obj/machinery/light{dir = 1; light_color = "#c1caff"},/turf/open/floor/plasteel/barber,/area/ruin/powered)
"am" = (/obj/machinery/vending/coffee,/turf/open/floor/plasteel/barber,/area/ruin/powered)
"an" = (/obj/structure/closet/crate/bin,/turf/open/floor/plasteel/barber,/area/ruin/powered)
"ao" = (/obj/structure/sink{dir = 8; pixel_x = -12},/obj/structure/mirror{pixel_x = -25},/turf/open/floor/plasteel/white,/area/ruin/powered)
"ap" = (/obj/structure/sign/poster/official/cleanliness{pixel_y = 32},/turf/open/floor/plasteel/white,/area/ruin/powered)
"aq" = (/obj/structure/toilet{dir = 8},/obj/structure/window/reinforced/tinted,/obj/machinery/door/window/westleft,/turf/open/floor/plasteel/white,/area/ruin/powered)
"ar" = (/obj/structure/filingcabinet/filingcabinet,/turf/open/floor/plasteel,/area/ruin/powered)
"as" = (/obj/structure/table/reinforced,/obj/item/paper_bin,/obj/item/pen/fourcolor,/obj/item/folder{pixel_x = -9},/obj/item/clipboard{pixel_x = 8},/obj/machinery/button/flasher{id = "researchbunkerflash1"; pixel_y = 7},/turf/open/floor/plasteel,/area/ruin/powered)
"at" = (/obj/structure/grille,/obj/effect/spawner/structure/window/reinforced,/turf/open/floor/plating,/area/ruin/powered)
"au" = (/obj/machinery/vending/wallmed{pixel_x = 25},/turf/open/floor/plating,/area/ruin/powered)
"av" = (/obj/machinery/light{dir = 8; light_color = "#e8eaff"},/turf/open/floor/plasteel/barber,/area/ruin/powered)
"aw" = (/turf/open/floor/plasteel/barber,/area/ruin/powered)
"ax" = (/obj/structure/sign/poster/contraband/space_up{pixel_x = 32},/turf/open/floor/plasteel/barber,/area/ruin/powered)
"ay" = (/obj/machinery/light{dir = 8; light_color = "#e8eaff"},/turf/open/floor/plasteel/white,/area/ruin/powered)
"az" = (/turf/open/floor/plasteel/white,/area/ruin/powered)
"aA" = (/obj/structure/toilet{dir = 8},/obj/machinery/door/window/westright,/turf/open/floor/plasteel/white,/area/ruin/powered)
"aB" = (/obj/machinery/door/airlock,/turf/open/floor/plasteel,/area/ruin/powered)
"aC" = (/obj/machinery/newscaster{pixel_x = -25},/turf/open/floor/plasteel/barber,/area/ruin/powered)
"aD" = (/obj/structure/chair{dir = 4},/turf/open/floor/plasteel/barber,/area/ruin/powered)
"aE" = (/obj/structure/table/glass,/turf/open/floor/plasteel/barber,/area/ruin/powered)
"aF" = (/obj/structure/chair{dir = 8},/turf/open/floor/plasteel/barber,/area/ruin/powered)
"aG" = (/obj/machinery/door/airlock,/turf/open/floor/plasteel/white,/area/ruin/powered)
"aH" = (/turf/open/floor/plasteel/whitepurple/side{dir = 9},/area/ruin/powered)
"aI" = (/turf/open/floor/plasteel/whitepurple/side{dir = 1},/area/ruin/powered)
"aJ" = (/turf/open/floor/plasteel/whitepurple/corner{dir = 1},/area/ruin/powered)
"aK" = (/turf/open/floor/plasteel/whitepurple/side{dir = 4},/area/ruin/powered)
"aL" = (/obj/machinery/door/airlock,/turf/open/floor/plasteel/barber,/area/ruin/powered)
"aM" = (/obj/structure/sign/restroom{pixel_y = 32},/turf/open/floor/plasteel/barber,/area/ruin/powered)
"aN" = (/turf/open/floor/plasteel/whitepurple/side{dir = 8},/area/ruin/powered)
"aO" = (/turf/open/floor/plasteel/whitepurple/corner,/area/ruin/powered)
"aP" = (/obj/machinery/light,/turf/open/floor/plasteel/whitepurple/side,/area/ruin/powered)
"aQ" = (/turf/open/floor/plasteel/whitepurple/side,/area/ruin/powered)
"aR" = (/obj/machinery/light,/turf/open/floor/plasteel/whitepurple/side{dir = 6},/area/ruin/powered)
"aS" = (/obj/machinery/light,/turf/open/floor/plasteel/barber,/area/ruin/powered)
"aT" = (/obj/machinery/door/airlock,/turf/open/floor/plasteel/whitepurple/side{dir = 8},/area/ruin/powered)
"aU" = (/obj/machinery/door/airlock,/turf/open/floor/plasteel/whitepurple/side{dir = 4},/area/ruin/powered)
"aV" = (/obj/machinery/door/airlock/wood,/turf/open/floor/wood,/area/ruin/powered)
"aW" = (/obj/machinery/light{dir = 4; light_color = "#e8eaff"},/turf/open/floor/plasteel/whitepurple/side{dir = 4},/area/ruin/powered)
"aX" = (/obj/structure/table/reinforced,/obj/item/photo{desc = "The picture is faded, the most you can make out is some grey splotch and pink limbs but thats about it"; name = "ruined photo"},/turf/open/floor/plasteel/whitepurple/side{dir = 9},/area/ruin/powered)
"aY" = (/obj/structure/table/reinforced,/obj/item/evidencebag,/obj/item/evidencebag,/obj/machinery/light{dir = 1; light_color = "#c1caff"},/obj/item/hand_labeler,/turf/open/floor/plasteel/whitepurple/side{dir = 1},/area/ruin/powered)
"aZ" = (/obj/structure/table/reinforced,/obj/item/paper_bin,/obj/item/clothing/glasses/regular,/obj/item/pen,/obj/structure/sign/poster/official/science{pixel_y = 32},/turf/open/floor/plasteel/whitepurple/side{dir = 1},/area/ruin/powered)
"ba" = (/obj/structure/table/reinforced,/obj/item/soap/nanotrasen,/obj/item/scalpel,/obj/item/clothing/gloves/color/latex/nitrile,/turf/open/floor/plasteel/whitepurple/side{dir = 5},/area/ruin/powered)
"bb" = (/obj/structure/bed,/obj/item/bedsheet/nanotrasen,/obj/structure/sign/poster/official/no_erp{pixel_x = -32},/turf/open/floor/wood,/area/ruin/powered)
"bc" = (/turf/open/floor/wood,/area/ruin/powered)
"bd" = (/obj/structure/bed,/obj/item/bedsheet/nanotrasen,/turf/open/floor/wood,/area/ruin/powered)
"be" = (/obj/structure/table/reinforced,/obj/item/device/camera_film{pixel_x = -6},/obj/item/device/camera,/obj/structure/sign/poster/official/wtf_is_co2{pixel_x = -32},/turf/open/floor/plasteel/whitepurple/side{dir = 8},/area/ruin/powered)
"bf" = (/obj/structure/chair/office/light{dir = 8},/turf/open/floor/plasteel/white,/area/ruin/powered)
"bg" = (/obj/structure/chair/office/light{dir = 4},/turf/open/floor/plasteel/white,/area/ruin/powered)
"bh" = (/obj/structure/closet/crate/freezer/surplus_limbs{name = "Leftovers"},/turf/open/floor/plasteel/whitepurple/side{dir = 4},/area/ruin/powered)
"bi" = (/obj/machinery/light,/turf/open/floor/wood,/area/ruin/powered)
"bj" = (/obj/structure/closet/crate/bin,/obj/machinery/light{dir = 8},/turf/open/floor/plasteel/whitepurple/side{dir = 8},/area/ruin/powered)
"bk" = (/obj/structure/table/reinforced,/obj/item/paper_bin,/obj/item/pen,/turf/open/floor/plasteel/whitepurple/side{dir = 8},/area/ruin/powered)
"bl" = (/obj/structure/chair/office/light,/turf/open/floor/plasteel/white,/area/ruin/powered)
"bm" = (/obj/machinery/light{dir = 1; light_color = "#c1caff"},/turf/open/floor/plasteel/white,/area/ruin/powered)
"bn" = (/obj/structure/chair{dir = 4},/turf/open/floor/plasteel/white,/area/ruin/powered)
"bo" = (/obj/structure/table/reinforced,/obj/item/device/taperecorder,/obj/item/device/tape,/turf/open/floor/plasteel/white,/area/ruin/powered)
"bp" = (/obj/structure/table/reinforced,/obj/item/scalpel,/obj/item/hemostat,/obj/item/retractor,/obj/item/surgicaldrill,/obj/item/surgical_drapes,/obj/item/cautery,/obj/item/circular_saw,/turf/open/floor/plasteel/white,/area/ruin/powered)
"bq" = (/obj/structure/table/reinforced,/obj/item/evidencebag,/obj/item/evidencebag,/obj/item/evidencebag,/obj/item/evidencebag,/obj/item/hand_labeler,/turf/open/floor/plasteel/white,/area/ruin/powered)
"br" = (/obj/structure/table/reinforced,/obj/item/defibrillator/loaded,/obj/item/restraints/handcuffs/cable/zipties,/obj/item/restraints/handcuffs/cable/zipties,/turf/open/floor/plasteel/white,/area/ruin/powered)
"bs" = (/obj/structure/table/reinforced,/obj/item/device/tape,/turf/open/floor/plasteel/whitepurple/side{dir = 10},/area/ruin/powered)
"bt" = (/obj/machinery/computer{dir = 1},/turf/open/floor/plasteel/whitepurple/side,/area/ruin/powered)
"bu" = (/obj/structure/filingcabinet,/turf/open/floor/plasteel/whitepurple/side,/area/ruin/powered)
"bv" = (/turf/open/floor/plasteel/whitepurple/side{dir = 6},/area/ruin/powered)
"bw" = (/obj/structure/table/reinforced,/obj/item/paper_bin,/obj/item/pen,/turf/open/floor/plasteel/white,/area/ruin/powered)
"bx" = (/obj/structure/table/optable,/obj/item/restraints/handcuffs/cable/zipties/used,/turf/open/floor/plasteel/white,/area/ruin/powered)
"by" = (/obj/structure/chair{dir = 8},/turf/open/floor/plasteel/white,/area/ruin/powered)
"bz" = (/obj/structure/table/reinforced,/obj/item/clothing/gloves/color/latex/nitrile,/obj/item/clothing/mask/surgical,/obj/item/clothing/suit/apron/surgical,/turf/open/floor/plasteel/white,/area/ruin/powered)
"bA" = (/obj/structure/sign/science{pixel_x = -32},/turf/open/floor/plasteel/whitepurple/side{dir = 8},/area/ruin/powered)
"bB" = (/obj/structure/sign/science{pixel_x = 32},/turf/open/floor/plasteel/whitepurple/side{dir = 4},/area/ruin/powered)
"bC" = (/obj/machinery/light,/turf/open/floor/plasteel/white,/area/ruin/powered)
"bD" = (/obj/structure/table/reinforced,/turf/open/floor/plasteel/white,/area/ruin/powered)
"bE" = (/obj/machinery/computer/operating{dir = 4},/turf/open/floor/plasteel/white,/area/ruin/powered)
"bF" = (/obj/structure/table/reinforced,/obj/item/bodybag,/turf/open/floor/plasteel/white,/area/ruin/powered)
"bG" = (/obj/machinery/door/airlock,/obj/machinery/door/poddoor/preopen{id = "lablockdown1"; name = "Lab Lockdown"},/turf/open/floor/plasteel/whitepurple/side{dir = 8},/area/ruin/powered)
"bH" = (/obj/machinery/door/airlock,/obj/machinery/door/poddoor/preopen{id = "lablockdown1"; name = "Lab Lockdown"},/turf/open/floor/plasteel/whitepurple/side{dir = 4},/area/ruin/powered)
"bI" = (/obj/structure/closet/emcloset/anchored,/obj/effect/turf_decal/stripes,/turf/open/floor/plating,/area/ruin/powered)
"bJ" = (/obj/machinery/shower{icon_state = "shower"; dir = 4},/obj/effect/turf_decal/stripes{dir = 4},/turf/open/floor/plating,/area/ruin/powered)
"bK" = (/turf/open/floor/plasteel/whitepurple/corner{dir = 4},/area/ruin/powered)
"bL" = (/obj/machinery/door/airlock,/obj/machinery/door/poddoor/preopen{id = "lablockdown1"; name = "Lab Lockdown"},/turf/open/floor/plasteel/whitepurple/side{dir = 1},/area/ruin/powered)
"bM" = (/obj/structure/noticeboard{pixel_y = 30},/turf/open/floor/plasteel/whitepurple/side{dir = 1},/area/ruin/powered)
"bN" = (/obj/structure/sign/poster/official/work_for_a_future{pixel_y = 32},/turf/open/floor/plasteel/whitepurple/side{dir = 1},/area/ruin/powered)
"bO" = (/obj/machinery/light{dir = 1; light_color = "#c1caff"},/turf/open/floor/plasteel/whitepurple/side{dir = 1},/area/ruin/powered)
"bP" = (/obj/structure/table/reinforced,/turf/open/floor/plasteel/whitepurple/side{dir = 5},/area/ruin/powered)
"bQ" = (/obj/machinery/light,/turf/open/floor/plasteel/whitepurple/side{dir = 10},/area/ruin/powered)
"bR" = (/obj/machinery/door/airlock,/obj/machinery/door/poddoor/preopen{id = "lablockdown1"; name = "Lab Lockdown"},/turf/open/floor/plasteel/whitepurple/side,/area/ruin/powered)
"bS" = (/obj/structure/sign/xeno_warning_mining{pixel_y = -30},/turf/open/floor/plasteel/whitepurple/side,/area/ruin/powered)
"bT" = (/obj/structure/table/reinforced,/obj/item/paper{info = "The next person to leave the specimen holding blast doors open gets janitor duty for the rest of the month! \[br]\[br] We need to increase our safety and secure protocol standards around here if we want to recieve additional grants from Central!"; name = "IMPORTANT NOTICE!"},/obj/machinery/button/door{id = "specimensentry1"; name = "Specimen Holding Control"; pixel_y = -25},/turf/open/floor/plasteel/whitepurple/side{dir = 6},/area/ruin/powered)
"bU" = (/obj/structure/window/reinforced{dir = 1; layer = 2.9},/turf/open/floor/plasteel/darkblue,/area/ruin/powered)
"bV" = (/obj/machinery/door/window/northleft,/turf/open/floor/plasteel/darkblue,/area/ruin/powered)
"bW" = (/obj/structure/chair/office/light{dir = 4},/obj/structure/window/reinforced{dir = 1; layer = 2.9},/turf/open/floor/plasteel/darkblue,/area/ruin/powered)
"bX" = (,/obj/structure/window/reinforced{dir = 4},/obj/structure/window/reinforced{dir = 1; layer = 2.9},/turf/open/floor/plasteel/darkblue,/area/ruin/powered)
"bY" = (/obj/machinery/door/window/northleft,/turf/open/floor/plasteel/white,/area/ruin/powered)
"bZ" = (/obj/structure/chair{dir = 8},/obj/structure/window/reinforced{dir = 1; layer = 2.9},/turf/open/floor/plasteel/white,/area/ruin/powered)
"ca" = (/obj/machinery/door/poddoor{id = "specimensentry1"; name = "Specimen Holding Blast Doors"},/turf/open/floor/engine,/area/ruin/powered)
"cb" = (,/turf/open/floor/plating,/area/ruin/powered)
"cc" = (/obj/machinery/door/airlock/highsecurity,/turf/open/floor/plasteel/darkblue,/area/ruin/powered)
"cd" = (/obj/structure/sign/securearea{pixel_x = -32; pixel_y = 32},/turf/open/floor/plasteel/darkblue,/area/ruin/powered)
"ce" = (/turf/open/floor/plasteel/darkblue,/area/ruin/powered)
"cf" = (/obj/structure/chair/office/light{dir = 4},/obj/machinery/button/door{id = "lablockdown1"; name = "Labs Lockdown"; pixel_x = 25; pixel_y = 0},/turf/open/floor/plasteel/darkblue,/area/ruin/powered)
"cg" = (/obj/structure/table/reinforced,/obj/structure/window/reinforced{dir = 4},/turf/open/floor/plasteel/darkblue,/area/ruin/powered)
"ch" = (/obj/machinery/light{dir = 4; light_color = "#e8eaff"},/turf/open/floor/plasteel/white,/area/ruin/powered)
"ci" = (/turf/open/floor/engine,/area/ruin/powered)
"cj" = (/obj/machinery/button/door{id = "specimensentry1"; name = "Specimen Holding Control"; pixel_y = 25},/turf/open/floor/engine,/area/ruin/powered)
"ck" = (/obj/structure/table/reinforced,/turf/open/floor/plasteel/darkblue,/area/ruin/powered)
"cl" = (/obj/structure/filingcabinet,/obj/machinery/light,/turf/open/floor/plasteel/darkblue,/area/ruin/powered)
"cm" = (/obj/structure/table/reinforced,/obj/item/paper_bin,/obj/item/pen/fountain,/turf/open/floor/plasteel/darkblue,/area/ruin/powered)
"cn" = (/obj/structure/table/reinforced,/obj/structure/window/reinforced{dir = 4},/obj/item/phone,/obj/item/device/megaphone/command,/turf/open/floor/plasteel/darkblue,/area/ruin/powered)
"co" = (/obj/structure/mopbucket,/obj/item/mop,/obj/item/reagent_containers/glass/bucket,/turf/open/floor/plasteel/white,/area/ruin/powered)
"cp" = (,/obj/machinery/light,/turf/open/floor/engine,/area/ruin/powered)
"cq" = (/obj/structure/disposaloutlet{dir = 4},/obj/structure/disposalpipe/trunk,/turf/open/floor/engine,/area/ruin/powered)
"cr" = (/obj/structure/sign/poster/contraband/fun_police{pixel_y = 32},/turf/open/floor/engine,/area/ruin/powered)
"cs" = (/mob/living/carbon/human/interactive/friendly,/turf/open/floor/engine,/area/ruin/powered)
"ct" = (/obj/structure/table/wood,/obj/item/twohanded/spear,/obj/item/restraints/handcuffs/cable/zipties/used,/turf/open/floor/engine,/area/ruin/powered)
"cu" = (/obj/structure/sign/poster/contraband/grey_tide{pixel_x = 0; pixel_y = 32},/turf/open/floor/engine,/area/ruin/powered)
"cv" = (/obj/structure/disposaloutlet{dir = 8},/obj/structure/disposalpipe/trunk,/turf/open/floor/engine,/area/ruin/powered)
"cw" = (/obj/structure/disposalpipe/segment,/obj/structure/sign/poster/contraband/pwr_game{pixel_x = -32},/obj/structure/table/wood,/obj/item/shard,/turf/open/floor/engine,/area/ruin/powered)
"cx" = (/obj/structure/bed,/obj/item/bedsheet/grey,/turf/open/floor/engine,/area/ruin/powered)
"cy" = (/obj/structure/table/wood,/obj/item/device/flashlight,/turf/open/floor/engine,/area/ruin/powered)
"cz" = (/obj/structure/disposalpipe/segment,/obj/structure/bed,/obj/item/bedsheet/grey,/turf/open/floor/engine,/area/ruin/powered)
"cA" = (/obj/structure/disposalpipe/segment,/obj/structure/table/wood,/obj/item/device/multitool,/turf/open/floor/engine,/area/ruin/powered)
"cB" = (/obj/structure/sign/poster/contraband/missing_gloves{pixel_x = 32},/turf/open/floor/engine,/area/ruin/powered)
"cC" = (/obj/structure/disposalpipe/segment,/obj/structure/sign/poster/contraband/hacking_guide{pixel_x = 32},/turf/open/floor/engine,/area/ruin/powered)
"cD" = (/obj/structure/grille,/obj/effect/spawner/structure/window/reinforced,/obj/structure/disposalpipe/segment,/obj/machinery/door/poddoor/shutters{id = "greyshutter1"; name = "Cell 1 Shutter"},/turf/open/floor/engine,/area/ruin/powered)
"cE" = (/obj/machinery/door/poddoor{id = "greydoor1"; name = "Cell 1 Blast Door"},/turf/open/floor/engine,/area/ruin/powered)
"cF" = (/obj/structure/grille,/obj/effect/spawner/structure/window/reinforced,/obj/machinery/door/poddoor/shutters{id = "greyshutter1"; name = "Cell 1 Shutter"},/turf/open/floor/engine,/area/ruin/powered)
"cG" = (/obj/structure/grille,/obj/effect/spawner/structure/window/reinforced,/obj/machinery/door/poddoor/shutters{id = "greyshutter2"; name = "Cell 2 Shutter"},/turf/open/floor/engine,/area/ruin/powered)
"cH" = (/obj/machinery/door/poddoor{id = "greydoor2"; name = "Cell 2 Blast Door"},/turf/open/floor/engine,/area/ruin/powered)
"cI" = (/obj/structure/grille,/obj/effect/spawner/structure/window/reinforced,/obj/structure/disposalpipe/segment,/obj/machinery/door/poddoor/shutters{id = "greyshutter2"; name = "Cell 2 Shutter"},/turf/open/floor/engine,/area/ruin/powered)
"cJ" = (/obj/effect/turf_decal/stripes{dir = 1},/obj/machinery/disposal/bin,/obj/structure/disposalpipe/trunk{dir = 1},/turf/open/floor/plasteel/whitepurple/side{dir = 9},/area/ruin/powered)
"cK" = (/obj/effect/turf_decal/stripes{dir = 1},/turf/open/floor/plasteel/whitepurple/side{dir = 1},/area/ruin/powered)
"cL" = (/obj/structure/table/reinforced,/obj/effect/turf_decal/stripes/end,/obj/structure/sign/xeno_warning_mining{pixel_y = 32},/turf/open/floor/plasteel/whitepurple/side{dir = 1},/area/ruin/powered)
"cM" = (/obj/effect/turf_decal/stripes{dir = 1},/obj/machinery/disposal/bin,/obj/structure/disposalpipe/trunk{dir = 1},/turf/open/floor/plasteel/whitepurple/side{dir = 5},/area/ruin/powered)
"cN" = (/obj/structure/table/reinforced,/obj/item/restraints/handcuffs/cable/zipties,/obj/item/restraints/handcuffs/cable/zipties,/turf/open/floor/plasteel/whitepurple/side{dir = 8},/area/ruin/powered)
"cO" = (/obj/machinery/button/door{id = "greydoor1"; name = "Cell 1 Door Control"; pixel_x = -6; pixel_y = 30},/obj/machinery/button/door{id = "greyshutter1"; name = "Cell 1 Shutters"; pixel_x = -6; pixel_y = 40},/obj/machinery/button/door{id = "greydoor2"; name = "Cell 2 Door Control"; pixel_x = 6; pixel_y = 30},/obj/machinery/button/door{id = "greyshutter2"; name = "Cell 2 Shutters"; pixel_x = 6; pixel_y = 40},/turf/open/floor/plasteel/white,/area/ruin/powered)
"cP" = (/obj/structure/table/reinforced,/obj/item/melee/baton,/obj/item/restraints/handcuffs,/obj/item/gun/energy/e_gun/mini,/turf/open/floor/engine,/area/ruin/powered)
"cQ" = (/obj/structure/table/reinforced,/obj/machinery/recharger,/turf/open/floor/engine,/area/ruin/powered)
"cR" = (/obj/structure/table/reinforced,/obj/item/storage/toolbox/electrical{pixel_y = 6},/obj/item/storage/toolbox/mechanical,/obj/structure/sign/poster/contraband/grey_tide{pixel_x = -32},/turf/open/floor/plasteel/whitepurple/side{dir = 8},/area/ruin/powered)
"cS" = (/obj/machinery/door/poddoor{id = "interiorspecimen1"; name = "Interior Blast Door"},/obj/effect/turf_decal/stripes{dir = 8},/turf/open/floor/engine,/area/ruin/powered)
"cT" = (/obj/machinery/door/poddoor{id = "outerspecimen1"; name = "Exterior Blast Door"},/obj/effect/turf_decal/stripes{dir = 4},/turf/open/floor/engine,/area/ruin/powered)
"cU" = (/turf/open/floor/plasteel/whitepurple/side{dir = 5},/area/ruin/powered)
"cV" = (/obj/structure/table/reinforced,/obj/item/storage/toolbox/emergency,/obj/item/stock_parts/cell/high,/obj/item/stock_parts/cell/high,/turf/open/floor/plasteel/whitepurple/side{dir = 10},/area/ruin/powered)
"cW" = (/obj/structure/table/reinforced,/obj/item/stack/sheet/glass/fifty,/obj/item/device/assembly/igniter,/obj/item/device/assembly/igniter,/turf/open/floor/plasteel/whitepurple/side,/area/ruin/powered)
"cX" = (/obj/structure/table/reinforced,/obj/item/stack/rods/ten,/obj/item/stack/cable_coil/blue,/turf/open/floor/plasteel/whitepurple/side,/area/ruin/powered)
"cY" = (/obj/structure/table/reinforced,/obj/item/clothing/gloves/color/yellow,/obj/item/clothing/gloves/color/yellow,/turf/open/floor/plasteel/whitepurple/side,/area/ruin/powered)
"cZ" = (/obj/structure/table/reinforced,/obj/item/storage/belt/utility/full/engi,/obj/item/storage/belt/utility/full/engi,/obj/item/device/multitool,/obj/item/device/multitool,/turf/open/floor/plasteel/whitepurple/side,/area/ruin/powered)
"da" = (/obj/machinery/button/door{id = "interiorspecimen1"; name = "Interior Blast Door Control"; pixel_y = -25},/turf/open/floor/plasteel/whitepurple/side{dir = 6},/area/ruin/powered)
"db" = (/obj/effect/turf_decal/stripes{dir = 8},/obj/machinery/door/poddoor{id = "interiorspecimen1"; name = "Interior Blast Door"},/turf/open/floor/engine,/area/ruin/powered)
"dc" = (/obj/machinery/button/door{id = "interiorspecimen1"; name = "Interior Blast Door Control"; pixel_y = -25},/turf/open/floor/engine,/area/ruin/powered)
"dd" = (/obj/machinery/button/door{id = "outerspecimen1"; name = "Exterior Blast Door Control"; pixel_y = -25},/turf/open/floor/engine,/area/ruin/powered)
"de" = (/obj/effect/turf_decal/stripes{dir = 4},/obj/machinery/door/poddoor{id = "outerspecimen1"; name = "Exterior Blast Door"},/turf/open/floor/engine,/area/ruin/powered)
"df" = (/obj/structure/grille,/obj/effect/spawner/structure/window/reinforced,/obj/machinery/door/poddoor/preopen{id = "specimenobs1"; name = "observation blast doors"},/turf/open/floor/plating,/area/ruin/powered)
"dg" = (/obj/machinery/button/door{id = "outerspecimen1"; name = "Exterior Blast Door Control"; pixel_x = -25},/turf/open/floor/plasteel/whitepurple/side{dir = 10},/area/ruin/powered)
"dh" = (/obj/structure/table/reinforced,/obj/item/clipboard,/obj/item/gun/energy/e_gun/mini,/turf/open/floor/plasteel/darkblue,/area/ruin/powered)
"di" = (/obj/structure/table/reinforced,/obj/item/device/taperecorder,/turf/open/floor/plasteel/darkblue,/area/ruin/powered)
"dj" = (/obj/structure/table/reinforced,/obj/item/folder/blue,/obj/item/folder/blue,/obj/item/device/tape,/obj/item/device/tape,/turf/open/floor/engine,/area/ruin/powered)
"dk" = (/obj/structure/filingcabinet,/turf/open/floor/engine,/area/ruin/powered)
"dl" = (/obj/structure/table/reinforced,/obj/item/folder/blue,/obj/item/device/tape,/turf/open/floor/engine,/area/ruin/powered)
"dm" = (/obj/structure/chair/comfy/brown{buildstackamount = 0; dir = 1},/obj/machinery/button/door{id = "specimenobs1"; name = "Observation Blast Doors"; pixel_y = 35},/turf/open/floor/plasteel/darkblue,/area/ruin/powered)
"dn" = (/obj/structure/table/reinforced,/obj/item/paper_bin,/obj/item/pen,/turf/open/floor/plasteel/darkblue,/area/ruin/powered)
"do" = (/obj/structure/table/reinforced,/obj/item/folder/documents,/turf/open/floor/engine,/area/ruin/powered)
"dp" = (,/turf/open/floor/plasteel/darkblue,/area/ruin/powered)
"dq" = (/obj/machinery/door/airlock/vault{locked = 1},/turf/open/floor/engine,/area/ruin/powered)
"dr" = (,/turf/open/floor/plasteel,/area/ruin/powered)

(1,1,1) = {"
aaaaabababababacacababababababababababab
aaaaabadaeafagahaiabajakalamanabaoapaqab
aaaaabaearasatahauabavawawawaxabayazaAab
aaababaBabababacacabaCaDaEaFawabaGababab
aaabaHaIaIaIaIaJaKaLawaDaEaFawaMawataaaa
aaabaNaOaPaQaQaQaRaLawawawaSawawawataaaa
aaabaTaUabababababababaVabababaVababaaaa
aaabaNaWabaXaYaZbaabbbbcbdabbdbcbdabaaaa
aaataNaKabbebfbgbhabbdbibdabbdbibdabaaaa
aaataNaKabbjazazaKababababababababababaa
aaataNaKabbkblazaWabazbmbnboatbpbqbrabaa
aaataNaWabbsbtbubvaGazazbnbwatbxbybzabaa
aaabbAbBababababazabazbCbnbDatbEazbFabaa
ababbGbHabbIbIabaGabababababababaGababaa
abbJaNbKbLaIaIbMaIbNbOaIaIaIaIbOaIbPabaa
abbJbQaQbRaQaQaQaQaQaQaQaQaQaQbSaQbTabaa
abababababbUbVbWbXbYbZbZbZbYababcaababaa
aaaaabcbcccdcecfcgazbybybychabcicicjabaa
aaaaabababckclcmcnazbybybycoabcicpciabaa
aaaaaaaaabababababababababababababababaa
"}

(1,1,2) = {"
aaaaaaaaaaaaaaaaaaaaaaaaaaaaaaaaaaaaaaaa
aaaaaaaaaaaaaaaaaaaaaaaaaaaaaaaaaaaaaaaa
aaaaaaaaaaaaaaaaaaaaaaaaaaaaaaaaaaaaaaaa
aaaaaaaaaaaaaaaaaaaaaaaaaaaaaaaaaaaaaaaa
aaaaaaaaaaaaaaaaaaaaaaaaaaaaaaaaaaaaaaaa
aaaaaaabababababababababaaaaaaaaaaaaaaaa
aaaaaaabcqcrcsabctcucvabaaaaaaaaaaaaaaaa
aaaaaaabcwcicxabcyciczabaaaaaaaaaaaaaaaa
aaaaaaabcAcicBabcscicCabaaaaaaaaaaaaaaaa
aaaaaaabcDcEcFabcGcHcIabaaaaaaaaaaaaaaaa
aaaaaaabcJcKcKcLcKcKcMababababaaaaaaaaaa
aaaaaaabcNazazcOazazaKabcPcQabababababaa
aaaaaaabcRazazazazazaKcScicicTaHaIcUabaa
aaaaaaabcVcWcXcYcZaQdadbdcdddeaNazaKabaa
aaaaaaababdfdfdfdfdfabababababdgaQbvabaa
aaaaaaaaabckdhckdickabdjdkdlababaBababaa
aaaaabababdmdndmdndmabcicidoabaeaeaeabaa
aaaaabdpcccececececeabcicidlabaeaeaeabaa
aaaaabababcececececedqcicidkabaedraeabaa
aaaaaaaaabababababababababababababababaa
"}
