"aa" = (/turf/open/space/basic,/area/space)
"ab" = (/turf/closed/indestructible/riveted{alpha = 0},/area/ship/federation/entax)
"ac" = (/obj/structure/chair/office/dark{dir = 1; name = "tactical swivel chair"},/obj/effect/turf_decal/trek{tag = "icon-trek_edge2 (SOUTHWEST)"; icon_state = "trek_edge2"; dir = 10},/obj/effect/turf_decal/trek/grey{icon_state = "trek_edge3"; dir = 10},/turf/open/floor/borg/trek/lit,/area/ship/federation/entax)
"ad" = (/obj/structure/chair/office/dark{dir = 1; name = "tactical swivel chair"},/obj/effect/turf_decal/trek{tag = "icon-trek_edge2 (SOUTHEAST)"; icon_state = "trek_edge2"; dir = 6},/obj/effect/turf_decal/trek/grey{icon_state = "trek_edge3"; dir = 6},/turf/open/floor/borg/trek/lit,/area/ship/federation/entax)
"ae" = (/obj/structure/fluff/helm/desk{desc = "Systems: NOMINAL"; dir = 1; name = "engineering desk"},/obj/effect/turf_decal/trek/grey{icon_state = "trek_edge3"; dir = 8},/turf/open/floor/borg/trek/lit,/area/ship/federation/entax)
"af" = (/obj/structure/fluff/helm/desk{desc = "Systems: NOMINAL"; dir = 1; name = "engineering desk"},/obj/effect/turf_decal/trek/grey{icon_state = "trek_edge3"; dir = 4},/turf/open/floor/borg/trek/lit,/area/ship/federation/entax)
"ag" = (/obj/effect/turf_decal/trek/grey{icon_state = "trek_edge3"; dir = 1},/turf/open/floor/borg/trek/lit{color = "#A9A9A9"},/area/ship/federation/entax)
"ah" = (/obj/effect/turf_decal/trek/grey{icon_state = "trek_edge3"; dir = 6},/obj/item/tricorder,/obj/structure/table/reinforced,/turf/open/floor/borg/trek/lit,/area/ship/federation/entax)
"ai" = (/obj/item/storage/firstaid,/obj/item/storage/firstaid/toxin,/obj/structure/table/reinforced,/obj/item/defibrillator/compact/loaded,/obj/item/reagent_containers/spray/cleaner,/obj/effect/turf_decal/trek/grey{icon_state = "trek_edge3"; dir = 5},/turf/open/floor/borg/trek/lit,/area/ship/federation/entax)
"aj" = (/obj/effect/turf_decal/trek/grey,/obj/machinery/sleeper,/turf/open/floor/borg/trek/lit,/area/ship/federation/entax)
"ak" = (/obj/structure/rack,/obj/structure/photon_torpedo,/obj/effect/turf_decal/trek/grey,/turf/open/floor/borg/trek/lit,/area/ship/federation/entax)
"al" = (/turf/open/floor/borg/trek/lit,/area/ship/federation/entax)
"am" = (/obj/structure/torpedo_launcher,/obj/effect/turf_decal/trek/grey,/turf/open/floor/borg/trek/lit,/area/ship/federation/entax)
"an" = (/obj/machinery/power/ship/phaser{tag = "icon-phaserarray"; icon_state = "phaserarray"; dir = 2},/obj/effect/turf_decal/trek/grey{icon_state = "trek_edge3"; dir = 1},/turf/open/floor/borg/trek/lit,/area/ship/federation/entax)
"ao" = (/obj/effect/landmark/runaboutdock,/turf/open/floor/borg/trek/lit,/area/ship/federation/entax)
"ap" = (/turf/open/floor/borg/trek/lit,/turf/closed/trekshield{icon_state = "shield"; dir = 8},/area/ship/federation/entax)
"aq" = (/obj/structure/overmap/ship/target,/obj/effect/turf_decal/trek/grey,/turf/open/floor/borg/trek/lit,/area/ship/federation/entax)
"ar" = (/obj/effect/turf_decal/trek/grey,/obj/machinery/iv_drip,/turf/open/floor/borg/trek/lit,/area/ship/federation/entax)
"at" = (/obj/effect/turf_decal/trek/grey{icon_state = "trek_edge3"; dir = 8},/turf/closed/wall/ship/voy,/area/ship/federation/entax)
"aw" = (/obj/item/storage/firstaid/brute,/obj/item/storage/firstaid/o2,/obj/structure/table/reinforced,/obj/item/defibrillator/compact/loaded,/obj/item/reagent_containers/spray/cleaner,/obj/item/reagent_containers/spray/cleaner,/obj/effect/turf_decal/trek/grey{icon_state = "trek_edge3"; dir = 4},/turf/open/floor/borg/trek/lit,/area/ship/federation/entax)
"az" = (/obj/item/storage/firstaid/fire,/obj/item/tricorder,/obj/structure/table/reinforced,/obj/effect/turf_decal/trek/grey{icon_state = "trek_edge3"; dir = 4},/turf/open/floor/borg/trek/lit,/area/ship/federation/entax)
"aA" = (/turf/closed/indestructible/riveted{alpha = 0; opacity = 0},/area/ship/federation/entax)
"aB" = (/obj/structure/special_trek_turf{tag = "icon-black (WEST)"; icon_state = "black"; dir = 8},/turf/open/floor/borg/trek/lit{color = "#A9A9A9"},/area/ship/federation/entax)
"aC" = (/turf/closed/wall/ship/voy,/area/ship/federation/entax)
"aD" = (/obj/machinery/door/airlock/trek/tng/voy,/turf/open/floor/borg/trek/lit,/area/ship/federation/entax)
"aF" = (/obj/structure/special_trek_turf/bridge/alt{pixel_y = -7},/turf/open/floor/borg/trek/lit{color = "#A9A9A9"},/area/ship/federation/entax)
"aG" = (/obj/structure/viewscreen{pixel_x = -5; pixel_y = -6},/turf/closed/indestructible/riveted{alpha = 0; opacity = 0},/area/ship/federation/entax)
"aH" = (/turf/open/space/basic,/area/ship/federation/entax)
"aI" = (/obj/structure/subsystem_monitor/weapons{tag = "icon-lcars2 (NORTHEAST)"; icon_state = "lcars2"; dir = 5},/turf/closed/indestructible/riveted{alpha = 0; opacity = 0},/area/ship/federation/entax)
"aJ" = (/obj/machinery/door/airlock/trek/tng/voy/single,/turf/open/floor/borg/trek/lit{color = "#A9A9A9"},/area/ship/federation/entax)
"aK" = (/turf/open/floor/borg/trek/lit{color = "#A9A9A9"},/area/ship/federation/entax)
"aL" = (/obj/structure/subsystem_monitor{tag = "icon-lcars (SOUTHWEST)"; icon_state = "lcars"; dir = 10},/turf/closed/indestructible/riveted{alpha = 0; opacity = 0},/area/ship/federation/entax)
"aM" = (/obj/structure/subsystem_monitor{tag = "icon-lcars (NORTHEAST)"; icon_state = "lcars"; dir = 5},/turf/open/floor/borg/trek/lit{color = "#A9A9A9"},/area/ship/federation/entax)
"aN" = (/obj/structure/subsystem_monitor/weapons{tag = "icon-lcars2 (NORTHWEST)"; icon_state = "lcars2"; dir = 9},/turf/open/floor/borg/trek/lit{color = "#A9A9A9"},/area/ship/federation/entax)
"aQ" = (/obj/structure/subsystem_panel/engines,/turf/closed/wall/ship/voy,/area/ship/federation/entax)
"aR" = (/obj/structure/ship_component,/turf/closed/wall/ship/voy,/area/ship/federation/entax)
"aS" = (/obj/structure/subsystem_panel/weapons,/turf/closed/wall/ship/voy,/area/ship/federation/entax)
"aT" = (/obj/structure/chair/office/dark{dir = 1; name = "tactical swivel chair"},/turf/open/floor/borg/trek/lit,/area/ship/federation/entax)
"aU" = (/obj/structure/fluff/helm/desk/tactical{tag = "icon-desk (NORTH)"; icon_state = "desk"; dir = 1},/turf/open/floor/borg/trek/lit,/area/ship/federation/entax)
"aV" = (/obj/structure/fluff/warpcore/massive/smaller{pixel_x = -16},/turf/open/floor/borg/trek/lit,/area/ship/federation/entax)
"aW" = (/obj/effect/turf_decal/trek/grey{icon_state = "trek_edge3"; dir = 9},/turf/open/floor/borg/trek/lit{color = "#A9A9A9"},/area/ship/federation/entax)
"aX" = (/obj/machinery/power/ship/phaser{tag = "icon-phaserarray"; icon_state = "phaserarray"; dir = 2},/turf/closed/wall/ship/voy,/area/ship/federation/entax)
"aY" = (/obj/machinery/trek/transporter{layer = 2},/turf/open/floor/borg/trek/lit,/area/ship/federation/entax)
"aZ" = (/obj/machinery/door/airlock/trek/tng/voy{tag = "icon-closed (WEST)"; icon_state = "closed"; dir = 8},/turf/open/floor/borg/trek/lit,/area/ship/federation/entax)
"ba" = (/obj/structure/special_trek_turf,/turf/open/floor/borg/trek/lit{color = "#A9A9A9"},/area/ship/federation/entax)
"bb" = (/obj/effect/turf_decal/trek/grey,/turf/open/floor/borg/trek/lit{color = "#A9A9A9"},/area/ship/federation/entax)
"bc" = (/obj/structure/fluff/helm/desk/noisy,/turf/open/floor/borg/trek/lit,/area/ship/federation/entax)
"bd" = (/obj/structure/fluff/helm/desk{tag = "icon-miniconsole (NORTH)"; icon_state = "miniconsole"; dir = 1},/turf/open/floor/borg/trek/lit,/area/ship/federation/entax)
"be" = (/obj/effect/turf_decal/trek/grey{icon_state = "trek_edge3"; dir = 5},/turf/open/floor/borg/trek/lit{color = "#A9A9A9"},/area/ship/federation/entax)
"bf" = (/obj/structure/special_trek_turf{dir = 1; icon_state = "black"; tag = "icon-black (NORTH)"},/turf/open/floor/borg/trek/lit{color = "#A9A9A9"},/area/ship/federation/entax)
"bg" = (/obj/machinery/computer/camera_advanced/transporter_control/huge,/turf/open/floor/borg/trek/lit,/area/ship/federation/entax)
"bh" = (/obj/effect/turf_decal/trek/grey{icon_state = "trek_edge3"; dir = 10},/turf/open/floor/borg/trek/lit{color = "#A9A9A9"},/area/ship/federation/entax)
"bi" = (/obj/structure/fluff/helm/desk/functional,/turf/open/floor/borg/trek/lit,/area/ship/federation/entax)
"bj" = (/obj/structure/chair/trek/bridge{tag = "icon-bridgechair (NORTH)"; icon_state = "bridgechair"; dir = 1},/turf/open/floor/borg/trek/lit,/area/ship/federation/entax)
"bk" = (/obj/structure/weapons_console,/turf/open/floor/borg/trek/lit,/area/ship/federation/entax)
"bl" = (/obj/effect/turf_decal/trek/grey{icon_state = "trek_edge3"; dir = 6},/turf/open/floor/borg/trek/lit{color = "#A9A9A9"},/area/ship/federation/entax)
"bm" = (/obj/effect/turf_decal/trek/grey{icon_state = "trek_edge3"; dir = 8},/turf/open/floor/borg/trek/lit{color = "#A9A9A9"},/area/ship/federation/entax)
"bn" = (/obj/effect/turf_decal/trek/grey{icon_state = "trek_edge3"; dir = 4},/turf/open/floor/borg/trek/lit{color = "#A9A9A9"},/area/ship/federation/entax)
"bu" = (/turf/open/bridge_overlay/alt,/area/ship/federation/entax)
"bv" = (/obj/machinery/door/airlock/trek/tng/voy,/turf/open/floor/borg/trek/lit{color = "#A9A9A9"},/area/ship/federation/entax)
"bE" = (/obj/machinery/door/airlock/trek/tng/voy{tag = "icon-closed (WEST)"; icon_state = "closed"; dir = 8},/turf/open/floor/borg/trek/lit{color = "#A9A9A9"},/area/ship/federation/entax)
"bI" = (/obj/structure/subsystem_panel,/turf/closed/wall/ship/voy,/area/ship/federation/entax)
"bJ" = (/obj/structure/ship_component/capbooster,/turf/closed/wall/ship/voy,/area/ship/federation/entax)
"bK" = (/obj/structure/sign/viewscreen{icon_state = "trekscreen"},/obj/effect/turf_decal/trek/grey{icon_state = "trek_edge3"; dir = 9},/turf/open/floor/borg/trek/lit,/area/ship/federation/entax)
"bL" = (/obj/structure/sign/viewscreen{icon_state = "trekscreen"},/obj/effect/turf_decal/trek/grey,/turf/open/floor/borg/trek/lit,/area/ship/federation/entax)
"bM" = (/obj/structure/closet/secure_closet/engineering_personal,/obj/item/storage/toolbox/electrical,/obj/effect/turf_decal/trek/grey{icon_state = "trek_edge3"; dir = 4},/turf/open/floor/borg/trek/lit,/area/ship/federation/entax)
"bN" = (/obj/structure/closet/secure_closet/engineering_personal,/obj/item/storage/toolbox/mechanical,/obj/effect/turf_decal/trek/grey{icon_state = "trek_edge3"; dir = 8},/turf/open/floor/borg/trek/lit,/area/ship/federation/entax)
"bO" = (/obj/structure/chair/trek{tag = "icon-chair (EAST)"; icon_state = "chair"; dir = 4},/turf/open/floor/borg/trek/lit{color = "#A9A9A9"},/area/ship/federation/entax)
"bP" = (/obj/structure/table/glass,/obj/item/storage/toolbox/mechanical,/turf/open/floor/borg/trek/lit{color = "#A9A9A9"},/area/ship/federation/entax)
"bQ" = (/obj/structure/table/glass,/turf/open/floor/borg/trek/lit{color = "#A9A9A9"},/area/ship/federation/entax)
"bR" = (/obj/structure/chair/trek{tag = "icon-chair (WEST)"; icon_state = "chair"; dir = 8},/turf/open/floor/borg/trek/lit{color = "#A9A9A9"},/area/ship/federation/entax)
"bT" = (/obj/structure/closet/secure_closet/engineering_personal,/obj/item/storage/toolbox/electrical,/obj/effect/turf_decal/trek/grey{icon_state = "trek_edge3"; dir = 10},/turf/open/floor/borg/trek/lit,/area/ship/federation/entax)
"bU" = (/obj/structure/closet/secure_closet/engineering_personal,/obj/item/storage/toolbox/mechanical,/obj/effect/turf_decal/trek/grey{icon_state = "trek_edge3"; dir = 6},/turf/open/floor/borg/trek/lit,/area/ship/federation/entax)
"bV" = (/obj/machinery/space_battle/shield_generator,/turf/closed/wall/ship/voy,/area/ship/federation/entax)
"bW" = (/obj/effect/turf_decal/trek/grey,/turf/open/floor/borg/trek/lit,/area/ship/federation/entax)
"bX" = (/obj/effect/turf_decal/trek/grey{icon_state = "trek_edge3"; dir = 9},/turf/open/floor/borg/trek/lit,/area/ship/federation/entax)
"bY" = (/obj/effect/turf_decal/trek/grey{icon_state = "trek_edge3"; dir = 5},/turf/open/floor/borg/trek/lit,/area/ship/federation/entax)
"bZ" = (/obj/effect/turf_decal/trek/grey{icon_state = "trek_edge3"; dir = 8},/turf/open/floor/borg/trek/lit,/area/ship/federation/entax)
"ca" = (/obj/effect/turf_decal/trek/grey{icon_state = "trek_edge3"; dir = 1},/turf/open/floor/borg/trek/lit,/area/ship/federation/entax)
"cb" = (/obj/effect/turf_decal/trek/grey{icon_state = "trek_edge3"; dir = 4},/turf/open/floor/borg/trek/lit,/area/ship/federation/entax)
"cc" = (/obj/effect/turf_decal/trek/grey{icon_state = "trek_edge3"; dir = 10},/turf/open/floor/borg/trek/lit,/area/ship/federation/entax)
"cd" = (/obj/effect/turf_decal/trek/grey{icon_state = "trek_edge3"; dir = 6},/turf/open/floor/borg/trek/lit,/area/ship/federation/entax)

(1,1,1) = {"
aaaaaaaaaaaaaaaaaaaaaaaaaaaaaaaaaaaaaaaaaaaaaaaaaaaaaaaaaaaaaaaaaaaaaaaaaaaaaaaaaaaaaaaaaaaaaaaaaaaa
aaaaaaaaaaaaaaaaaaaaaaaaaaaaaaaaaaaaaaaaaaaaaaaaaaaaaaaaaaaaaaaaaaaaaaaaaaaaaaaaaaaaaaaaaaaaaaaaaaaa
aaaaaaaaaaaaaaaaaaaaaaaaaaaaaaaaaaaaaaaaaaaaaaaaaaaaaaaaaaaaaaaaaaaaaaaaaaaaaaaaaaaaaaaaaaaaaaaaaaaa
aaaaaaaaaaaaaaaaaaaaaaaaaaaaaaaaaaaaaaaaaaaaaaaaaaaaaaaaaaaaaaaaaaaaaaaaaaaaaaaaaaaaaaaaaaaaaaaaaaaa
aaaaaaaaaaaaaaaaaaaaaaaaaaaaaaaaaaaaaaaaaaaaaaaaaaaaaaaaaaaaaaaaaaaaaaaaaaaaaaaaaaaaaaaaaaaaaaaaaaaa
aaaaaaaaaaaaaaaaaaaaaaaaaaaaaaaaaaaaaaaaaaaaaaaaaaaaaaaaaaaaaaaaaaaaaaaaaaaaaaaaaaaaaaaaaaaaaaaaaaaa
aaaaaaaaaaaaaaaaaaaaaaaaaaaaaaaaaaaaaaaaaaaaaaaaaaaaaaaaaaaaaaaaaaaaaaaaaaaaaaaaaaaaaaaaaaaaaaaaaaaa
aaaaaaaaaaaaaaaaaaaaaaaaaaaaaaaaaaaaaaaaaaaaaaaaaaaaaaaaaaaaaaaaaaaaaaaaaaaaaaaaaaaaaaaaaaaaaaaaaaaa
aaaaaaaaaaaaaaaaaaaaaaaaaaaaaaaaaaaaaaaaaaaaaaaaaaaaaaaaaaaaaaaaaaaaaaaaaaaaaaaaaaaaaaaaaaaaaaaaaaaa
aaaaaCaCaCaCaCaCaCaCaCaCaCaCaCaCaCaCaCaCaCaaaaaaaaaaaaaaaaaaaaaaaaaaaaaaaaaaaaaaaaaaaaaaaaaaaaaaaaaa
aaaaaCbXbWbWbWbWbWbWbWaZbWbWajajajarbWaiaCaaaaaaaaaaaaaaaaaaaaaaaaaaaaaaaaaaaaaaaaaaaaaaaaaaaaaaaaaa
aaaaaCbZaYaYalalalalalaCalalalalalalalawaCaaaaaaaaaaaaaaaaaaaaaaaaaaaaaaaaaaaaaaaaaaaaaaaaaaaaaaaaaa
aaaaaCbZaYaYalbgalalalaCalalalalalalalazaCaaaaaaaaaaaaaaaaaaaaaaaaaaaaaaaaaaaaaaaaaaaaaaaaaaaaaaaaaa
aaaaaCcccacacacacacacaaZcacacacacacacaahaCaaaaaaaaaaaaaaaaaaaaaaaaaaaaaaaaaaaaaaaaaaaaaaaaaaaaaaaaaa
aCaCaCataCaCaCaDaCaCaCaCaCaCaCaDaCaCaCaCaCaCaCaaaaaaaaaaaaaaaaaaaaaaaaaaaaaaaaaaaaaaaaaaaaaaaaaaaaaa
aCbXbWbWbWbWbWbWbWbWbWbWbWbWbWbWbWbWbWbWbWbYaCaaaaaaaaaaaaaaaaaaaaaaaaaaaaaaaaaaaaaaaaaaaaaaaaaaaaaa
aCbZalcacacacacacacacacacacacacacacacacaalcbaCaaaaaaaaaaaaaaaaaaaaaaaaaaaaaaaaaaaaaaaaaaaaaaaaaaaaaa
aCbZcbaCaCaCaCaDaCaCaCaCaCaCaCaDaCaCaCaCbZcbaCaaaaaaaaaaaaaaaaaaaaaaaaaaaaaaaaaaaaaaaaaaaaaaaaaaaaaa
aCbZcbaCabababaBabababababababaBabababaCbZcbaCaaaaaaaaaaaaaaaaaaaaaaaaaaaaaaaaaaaaaaaaaaaaaaaaaaaaaa
aCbZcbaCaAabaAaFaAaAaGaAaAaAaAaFaAabaHaCbZcbaCaaaaaaaaaaaaaaaaaaaaaaaaaaaaaaaaaaaaaaaaaaaaaaaaaaaaaa
aCbZcbaCabaAaIaJaAaKaKaKaKaKaAaJaLaAabaCbZcbaCaCaCaCaCaCaCaCaCaaaaaaaaaaaaaaaaaaaaaaaaaaaaaaaaaaaaaa
aCbZcbaCabaAaMaKaKaKaKaKaKaKaKaKaNaAabaCbZcbaCbXakbWambWakbYaCaaaaaaaaaaaaaaaaaaaaaaaaaaaaaaaaaaaaaa
aCbZcbaCabaKaKbXbWbWbWbWbWbWbWbYaKaKabaCbZcbaCbZalalalalalcbaCaaaaaaaaaaaaaaaaaaaaaaaaaaaaaaaaaaaaaa
aCbZcbaCabaKaKbZalalaTaUaTalalcbaKaKabaCbZcbaCbZalalalalalcbaXaaaaaaaaaaaaaaaaaaaaaaaaaaaaaaaaaaaaaa
aCbZcbaZbaaKaKbZalbcalalalbdalcbaKaKbfaZbZcbaZbZalalalalalcbaCaaaaaaaaaaaaaaaaaaaaaaaaaaaaaaaaaaaaaa
aCbZcbaCabaKaKaebialalbjalalbkafaKaKabaCbZcbaCbZalalalalalcbaCaaaaaaaaaaaaaaaaaaaaaaaaaaaaaaaaaaaaaa
aCbZcbaCabaKaKaccacacacacacacaadaKaKabaCbZcbaCbZalalalalalcbaCaaaaaaaaaaaaaaaaaaaaaaaaaaaaaaaaaaaaaa
aCbZcbaCaAabaKagaKaKaKaKaKaKaKagaKababaCbZcbaCccancacacacacdaXaaaaaaaaaaaaaaaaaaaaaaaaaaaaaaaaaaaaaa
aCbZcbaCbuababaBabababababababaBabababaCbZcbaCaCaCbvaCbvaCaCaCaaaaaaaaaaaaaaaaaaaaaaaaaaaaaaaaaaaaaa
aCbZcbaCaCaCaCaDaCaCaCaCaCaCaCaDaCaCaCaCbZcbaCalalalalalalalaCaaaaaaaaaaaaaaaaaaaaaaaaaaaaaaaaaaaaaa
aCbZalbWbWaqbWbWbWbWbWbWbWbWbWbWbWbWbWbWalcbaCalalalalalalalaCaaaaaaaaaaaaaaaaaaaaaaaaaaaaaaaaaaaaaa
aCcccacacacacacacacacacacacacacacacacacacacdaCalalalalalalalaCaaaaaaaaaaaaaaaaaaaaaaaaaaaaaaaaaaaaaa
aCaCaCaCaDaCaCaQaRaCbJaCbJaCaRaSaCaCaDaCaCaCaCalalalalalalalaCaaaaaaaaaaaaaaaaaaaaaaaaaaaaaaaaaaaaaa
aaaaaCbXbYaCaWbbbbbbbbbbbbbbbbbbbeaCbXbYaCaaaCalaoalalalalalaCaaaaaaaaaaaaaaaaaaaaaaaaaaaaaaaaaaaaaa
aaaaaCbZcbaCbmalalalalalalalalalbnaCbZcbaCaaaCapapapapapapapaCaaaaaaaaaaaaaaaaaaaaaaaaaaaaaaaaaaaaaa
aaaaaCbZcbaCbmalalalalalalalalalbnaCbZcbaCaaaaaaaaaaaaaaaaaaaaaaaaaaaaaaaaaaaaaaaaaaaaaaaaaaaaaaaaaa
aaaaaCbZcbaCbmalalalalalalalalalbnaCbZcbaCaaaaaaaaaaaaaaaaaaaaaaaaaaaaaaaaaaaaaaaaaaaaaaaaaaaaaaaaaa
aaaaaCbZcbaCbmalalalalalalalalalbnaCbZcbaCaaaaaaaaaaaaaaaaaaaaaaaaaaaaaaaaaaaaaaaaaaaaaaaaaaaaaaaaaa
aaaaaCbZcbaCbmalalalalalalalalalbnaCbZcbaCaaaaaaaaaaaaaaaaaaaaaaaaaaaaaaaaaaaaaaaaaaaaaaaaaaaaaaaaaa
aaaaaCbZcbaCbmalaValalalalalalalbnaCbZcbaCaaaaaaaaaaaaaaaaaaaaaaaaaaaaaaaaaaaaaaaaaaaaaaaaaaaaaaaaaa
aaaaaCbZcbbEbmalalalalalalalalalbnbEbZcbaCaaaaaaaaaaaaaaaaaaaaaaaaaaaaaaaaaaaaaaaaaaaaaaaaaaaaaaaaaa
aaaaaCbZcbaCbmalalalalalalalalalbnaCbZcbaCaaaaaaaaaaaaaaaaaaaaaaaaaaaaaaaaaaaaaaaaaaaaaaaaaaaaaaaaaa
aaaaaCbZcbaCbmalalalalalalalalalbnaCbZcbaCaaaaaaaaaaaaaaaaaaaaaaaaaaaaaaaaaaaaaaaaaaaaaaaaaaaaaaaaaa
aaaaaCbZcbaCbhagagagagagagagagagblaCbZcbaCaaaaaaaaaaaaaaaaaaaaaaaaaaaaaaaaaaaaaaaaaaaaaaaaaaaaaaaaaa
aaaaaCbZcbaCaCaCaCbvaCbIaCbvbJaCaCaCbZcbaCaaaaaaaaaaaaaaaaaaaaaaaaaaaaaaaaaaaaaaaaaaaaaaaaaaaaaaaaaa
aaaaaCbZcbaCbKbWbWbWbWbWbWbWbLbWbYaCbZcbaCaaaaaaaaaaaaaaaaaaaaaaaaaaaaaaaaaaaaaaaaaaaaaaaaaaaaaaaaaa
aaaaaCbZcbaCbNaKaKbObPbQbQbRaKaKbMaCbZcbaCaaaaaaaaaaaaaaaaaaaaaaaaaaaaaaaaaaaaaaaaaaaaaaaaaaaaaaaaaa
aaaaaCbZcbaCbZaKaKbObQbQbQbRaKaKcbaCbZcbaCaaaaaaaaaaaaaaaaaaaaaaaaaaaaaaaaaaaaaaaaaaaaaaaaaaaaaaaaaa
aaaaaCcccdaCbTcacacacacacacacacabUaCcccdaCaaaaaaaaaaaaaaaaaaaaaaaaaaaaaaaaaaaaaaaaaaaaaaaaaaaaaaaaaa
aaaaaCaCaCaCaCaCaCaCaCbVaCaCaCaCaCaCaCaCaCaaaaaaaaaaaaaaaaaaaaaaaaaaaaaaaaaaaaaaaaaaaaaaaaaaaaaaaaaa
"}
