"aa" = (/turf/closed/wall/trek{icon_state = "black"},/area/space)
"ab" = (/turf/closed/indestructible/transporter_block,/area/ship/mirandaDIY)
"ac" = (/obj/structure/viewscreen{icon_state = "viewscreenmini"; pixel_x = -5; pixel_y = 1},/turf/closed/indestructible/transporter_block,/area/ship/mirandaDIY)
"ad" = (/turf/closed/indestructible/transporter_block,/area/space)
"ae" = (/turf/closed/wall/trek{icon_state = "black"},/area/ship/mirandaDIY)
"af" = (/obj/structure/fluff/helm/desk/tactical/defiant{pixel_x = 26},/turf/open/floor/plating,/area/ship/mirandaDIY)
"ag" = (/obj/machinery/light{dir = 8},/turf/open/floor/plating,/area/ship/mirandaDIY)
"ah" = (/obj/machinery/light{dir = 4},/turf/open/floor/plating,/area/ship/mirandaDIY)
"ai" = (/obj/structure/replicator,/turf/open/floor/plating,/area/ship/mirandaDIY)
"aj" = (/obj/structure/overmap/ship/target/diy,/turf/open/floor/plating,/area/ship/mirandaDIY)
"ak" = (/turf/closed/wall/trek{icon_state = "wall_light"; dir = 4},/area/ship/mirandaDIY)
"al" = (/turf/closed/wall/trek{icon_state = "stationwall"; dir = 1},/area/ship/mirandaDIY)
"am" = (/turf/closed/wall/trek{icon_state = "wall_light"; dir = 8},/area/ship/mirandaDIY)
"an" = (/obj/structure/subsystem_panel,/turf/closed/wall/trek{icon_state = "stationwall"; dir = 1},/area/ship/mirandaDIY)
"ao" = (/turf/closed/wall/trek{icon_state = "jeffriestube"; dir = 1},/area/ship/mirandaDIY)
"ap" = (/obj/structure/catwalk,/turf/open/floor/borg/trek/lit{color = "#A9A9A9"},/area/ship/mirandaDIY)
"aq" = (/obj/machinery/power/warp_coil,/obj/structure/cable/white{icon_state = "0-4"},/turf/open/floor/plating,/area/ship/mirandaDIY)
"ar" = (/obj/structure/catwalk,/obj/structure/cable/white{icon_state = "2-8"},/turf/open/floor/borg/trek/lit{color = "#A9A9A9"},/area/ship/mirandaDIY)
"as" = (/turf/closed/wall/trek{icon_state = "jeffriestube"; dir = 2},/area/ship/mirandaDIY)
"at" = (/obj/structure/cable/white,/turf/open/floor/plating,/area/ship/mirandaDIY)
"au" = (/obj/structure/hailing_console/defiant,/turf/open/floor/plating,/area/ship/mirandaDIY)
"av" = (/obj/structure/subsystem_panel/weapons,/turf/closed/wall/trek{icon_state = "stationwall"; dir = 1},/area/ship/mirandaDIY)
"aw" = (/obj/structure/catwalk,/obj/structure/cable/white{icon_state = "2-8"},/obj/structure/cable/white{icon_state = "1-2"},/turf/open/floor/borg/trek/lit{color = "#A9A9A9"},/area/ship/mirandaDIY)
"ax" = (/obj/structure/weapons_console/defiant{pixel_x = -12},/turf/open/floor/plating,/area/ship/mirandaDIY)
"ay" = (/turf/open/floor/plating,/obj/machinery/atmospherics/pipe/simple/orange/hidden{icon_state = "intact"; dir = 1},/turf/closed/trekshield{icon_state = "shield"; dir = 4},/area/ship/mirandaDIY)
"az" = (/obj/machinery/atmospherics/pipe/layer_manifold,/obj/structure/catwalk,/turf/open/floor/plating,/area/ship/mirandaDIY)
"aA" = (/obj/structure/window/specialtrek,/turf/open/floor/fakespace,/area/ship/mirandaDIY)
"aB" = (/obj/machinery/power/warp_coil,/obj/machinery/atmospherics/components/unary/outlet_injector,/obj/structure/cable/white{icon_state = "0-4"},/turf/open/floor/plating,/area/ship/mirandaDIY)
"aC" = (/obj/machinery/atmospherics/pipe/simple/orange/hidden{icon_state = "intact"; dir = 6},/obj/machinery/atmospherics/components/binary/pump,/obj/structure/cable/white{icon_state = "2-4"},/obj/structure/catwalk,/turf/open/floor/plating,/area/ship/mirandaDIY)
"aD" = (/obj/machinery/atmospherics/pipe/simple/orange/hidden{icon_state = "intact"; dir = 8},/obj/structure/cable/white{icon_state = "4-8"},/obj/structure/catwalk,/turf/open/floor/plating,/area/ship/mirandaDIY)
"aE" = (/obj/machinery/door/airlock/trek/tng/jeffries,/obj/machinery/atmospherics/pipe/simple/orange/hidden{icon_state = "intact"; dir = 1},/obj/structure/cable/white{icon_state = "1-2"},/turf/open/floor/plating,/area/ship/mirandaDIY)
"aF" = (/obj/structure/cable/white{icon_state = "1-2"},/obj/structure/cable/white{icon_state = "2-4"},/turf/open/floor/plating,/area/ship/mirandaDIY)
"aG" = (/obj/machinery/trek/transporter,/turf/open/floor/plating,/area/ship/mirandaDIY)
"aH" = (/obj/machinery/atmospherics/pipe/simple/orange/hidden{icon_state = "intact"; dir = 1},/turf/open/floor/plating,/area/ship/mirandaDIY)
"aI" = (/obj/structure/catwalk,/obj/structure/cable/white{icon_state = "1-2"},/turf/open/floor/borg/trek/lit{color = "#A9A9A9"},/area/ship/mirandaDIY)
"aJ" = (/obj/machinery/atmospherics/pipe/simple/orange/hidden{icon_state = "intact"; dir = 1},/obj/structure/cable/white{icon_state = "1-2"},/obj/structure/catwalk,/turf/open/floor/plating,/area/ship/mirandaDIY)
"aK" = (/obj/item/pipe_dispenser,/obj/item/pipe_dispenser,/turf/open/floor/plating,/area/ship/mirandaDIY)
"aL" = (/obj/machinery/computer/camera_advanced/transporter_control,/turf/open/floor/plating,/area/ship/mirandaDIY)
"aM" = (/turf/open/floor/plating,/obj/structure/cable/white{icon_state = "1-2"},/turf/closed/trekshield{icon_state = "shield"; dir = 4},/area/ship/mirandaDIY)
"aN" = (/obj/machinery/ship/phaser{tag = "icon-phaserarray"; icon_state = "phaserarray"; dir = 2},/turf/open/floor/plating,/area/ship/mirandaDIY)
"aP" = (/obj/machinery/atmospherics/components/unary/tank/air,/turf/closed/wall/trek{icon_state = "stationwall"; dir = 1},/area/ship/mirandaDIY)
"aQ" = (/obj/machinery/airalarm,/turf/closed/wall/trek{icon_state = "stationwall"; dir = 1},/area/ship/mirandaDIY)
"aR" = (/obj/machinery/atmospherics/components/unary/tank{color = "#FF0000"},/turf/closed/wall/trek{icon_state = "stationwall"; dir = 1},/area/ship/mirandaDIY)
"aS" = (/obj/structure/sign/warning/electricshock,/turf/closed/wall/trek{icon_state = "stationwall"; dir = 1},/area/ship/mirandaDIY)
"aT" = (/turf/open/floor/plating,/turf/closed/trekshield{icon_state = "shield"; dir = 4},/area/ship/mirandaDIY)
"aU" = (/obj/structure/subsystem_panel/engines,/turf/closed/wall/trek{icon_state = "stationwall"; dir = 1},/area/ship/mirandaDIY)
"aW" = (/obj/item/storage/toolbox/mechanical,/obj/item/storage/toolbox/electrical,/obj/item/rcd_ammo/large,/obj/item/rcd_ammo/large,/obj/item/construction/rcd,/obj/item/construction/rcd,/turf/open/floor/plating,/area/ship/mirandaDIY)
"aX" = (/obj/structure/cable/white{icon_state = "1-4"},/turf/open/floor/plating,/area/ship/mirandaDIY)
"ba" = (/turf/closed/wall/trek{icon_state = "wall_light"; dir = 1},/area/ship/mirandaDIY)
"bc" = (/obj/machinery/atmospherics/components/binary/pump/on,/turf/open/floor/plating,/area/ship/mirandaDIY)
"bd" = (/obj/structure/catwalk,/obj/machinery/light{dir = 1},/turf/open/floor/plating,/area/ship/mirandaDIY)
"be" = (/obj/structure/catwalk,/turf/open/floor/plating,/area/ship/mirandaDIY)
"bf" = (/obj/machinery/atmospherics/components/binary/volume_pump/on{icon_state = "volpump_on_map"; dir = 1},/turf/open/floor/plating,/area/ship/mirandaDIY)
"bg" = (/obj/structure/warp_storage,/obj/structure/catwalk,/turf/open/floor/plating,/area/ship/mirandaDIY)
"bh" = (/obj/structure/cable/white{icon_state = "2-4"},/obj/machinery/atmospherics/components/binary/valve,/turf/open/floor/plating,/area/ship/mirandaDIY)
"bi" = (/obj/structure/cable/white{icon_state = "1-4"},/obj/structure/cable/white{icon_state = "4-8"},/obj/structure/catwalk,/turf/open/floor/plating,/area/ship/mirandaDIY)
"bj" = (/obj/structure/catwalk,/obj/structure/cable/white{icon_state = "2-8"},/turf/open/floor/plating,/area/ship/mirandaDIY)
"bl" = (/turf/closed/wall/trek{icon_state = "wall_light"},/area/ship/mirandaDIY)
"bm" = (/obj/machinery/atmospherics/pipe/layer_manifold,/turf/open/floor/plating,/area/ship/mirandaDIY)
"bn" = (/obj/structure/antimatter_storage,/obj/structure/catwalk,/turf/open/floor/borg/trek/lit{color = "#A9A9A9"},/area/ship/mirandaDIY)
"bo" = (/obj/structure/catwalk,/obj/machinery/light,/turf/open/floor/plating,/area/ship/mirandaDIY)
"bp" = (/obj/structure/cable/white{icon_state = "1-2"},/obj/machinery/atmospherics/pipe/simple/orange/hidden{icon_state = "intact"; dir = 1},/obj/machinery/meter,/turf/open/floor/plating,/area/ship/mirandaDIY)
"bq" = (/obj/structure/catwalk,/obj/machinery/power/apc,/obj/structure/cable/white,/turf/open/floor/borg/trek/lit{color = "#A9A9A9"},/area/ship/mirandaDIY)
"bs" = (/obj/effect/landmark/runaboutdock,/turf/open/floor/plating,/area/ship/mirandaDIY)
"bt" = (/obj/machinery/atmospherics/components/binary/pump,/turf/open/floor/plating,/area/ship/mirandaDIY)
"bu" = (/obj/machinery/atmospherics/pipe/simple/supply/hidden/layer1{icon_state = "intact"; dir = 5},/obj/machinery/portable_atmospherics/scrubber,/turf/open/floor/plating,/area/ship/mirandaDIY)
"bv" = (/obj/machinery/atmospherics/pipe/simple/supply/hidden/layer1{icon_state = "intact"; dir = 4},/turf/open/floor/plating,/area/ship/mirandaDIY)
"bw" = (/obj/machinery/atmospherics/pipe/simple/supply/hidden/layer1{icon_state = "intact"; dir = 10},/obj/machinery/atmospherics/pipe/simple/scrubbers/hidden/layer3{icon_state = "intact"; dir = 6},/turf/open/floor/plating,/area/ship/mirandaDIY)
"bx" = (/obj/machinery/atmospherics/pipe/simple/scrubbers/hidden/layer3{icon_state = "intact"; dir = 4},/turf/open/floor/plating,/area/ship/mirandaDIY)
"by" = (/obj/machinery/atmospherics/pipe/simple/scrubbers/hidden/layer3{icon_state = "intact"; dir = 9},/obj/machinery/portable_atmospherics/scrubber,/turf/open/floor/plating,/area/ship/mirandaDIY)
"bz" = (/obj/structure/cable/white{icon_state = "2-4"},/turf/closed/wall/trek{icon_state = "stationwall"; dir = 1},/area/ship/mirandaDIY)
"bA" = (/obj/structure/sign/warning/securearea,/obj/structure/cable/white{icon_state = "4-8"},/turf/closed/wall/trek{icon_state = "stationwall"; dir = 1},/area/ship/mirandaDIY)
"bB" = (/obj/structure/cable/white{icon_state = "1-2"},/obj/machinery/door/airlock/trek/tng/jeffries,/obj/machinery/atmospherics/pipe/simple/orange/hidden{icon_state = "intact"; dir = 1},/obj/structure/cable/white{icon_state = "2-8"},/obj/structure/cable/white{icon_state = "2-4"},/turf/open/floor/borg/trek/lit{color = "#A9A9A9"},/area/ship/mirandaDIY)
"bC" = (/obj/structure/cable/white{icon_state = "2-8"},/turf/closed/wall/trek{icon_state = "stationwall"; dir = 1},/area/ship/mirandaDIY)
"bI" = (/turf/closed/wall/trek{icon_state = "black2"; dir = 8},/area/ship/mirandaDIY)
"bJ" = (/obj/structure/fluff/ship/sticker,/turf/closed/wall/trek{icon_state = "stationwall"; dir = 1},/area/ship/mirandaDIY)
"bK" = (/obj/machinery/door/airlock/trek/tng/jeffries,/obj/machinery/atmospherics/pipe/simple/supply/hidden/layer1,/obj/machinery/atmospherics/pipe/simple/scrubbers/hidden/layer3,/turf/open/floor/borg/trek/lit{color = "#A9A9A9"},/area/ship/mirandaDIY)
"bL" = (/turf/closed/wall/trek{dir = 1; icon_state = "black2"},/area/ship/mirandaDIY)
"bM" = (/obj/structure/catwalk,/obj/machinery/power/smes/engineering,/obj/structure/cable/white,/turf/open/floor/borg/trek/lit{color = "#A9A9A9"},/area/ship/mirandaDIY)
"bN" = (/obj/structure/catwalk,/obj/machinery/light{dir = 1},/obj/machinery/power/terminal{icon_state = "term"; dir = 8},/obj/structure/cable/white{icon_state = "0-4"},/turf/open/floor/borg/trek/lit{color = "#A9A9A9"},/area/ship/mirandaDIY)
"bO" = (/obj/structure/catwalk,/obj/structure/cable/white{icon_state = "1-2"},/obj/machinery/atmospherics/pipe/simple/orange/hidden{icon_state = "intact"; dir = 1},/obj/structure/cable/white{icon_state = "2-8"},/obj/structure/cable/white{icon_state = "2-4"},/turf/open/floor/borg/trek/lit{color = "#A9A9A9"},/area/ship/mirandaDIY)
"bP" = (/obj/structure/catwalk,/obj/machinery/light{dir = 1},/obj/machinery/power/terminal{icon_state = "term"; dir = 4},/obj/structure/cable/white{icon_state = "0-8"},/turf/open/floor/borg/trek/lit{color = "#A9A9A9"},/area/ship/mirandaDIY)
"bQ" = (/turf/closed/wall/trek{icon_state = "wall_light"; dir = 9},/area/ship/mirandaDIY)
"bR" = (/obj/machinery/atmospherics/pipe/simple/orange/hidden,/obj/structure/cable/white{icon_state = "4-8"},/turf/open/floor/plating,/area/ship/mirandaDIY)
"bS" = (/obj/structure/cable/white{icon_state = "4-8"},/turf/open/floor/plating,/area/ship/mirandaDIY)
"bT" = (/obj/machinery/atmospherics/pipe/simple/cyan/hidden{icon_state = "intact"; dir = 1},/obj/structure/cable/white{icon_state = "4-8"},/turf/open/floor/plating,/area/ship/mirandaDIY)
"bU" = (/turf/closed/wall/trek{icon_state = "wall_light"; dir = 5},/area/ship/mirandaDIY)
"bV" = (/obj/machinery/atmospherics/pipe/simple/supply/hidden/layer1,/obj/machinery/atmospherics/pipe/simple/scrubbers/hidden/layer3,/obj/structure/catwalk,/turf/open/floor/plating,/area/ship/mirandaDIY)
"bW" = (/turf/closed/wall/trek{icon_state = "black"; dir = 1},/area/ship/mirandaDIY)
"bX" = (/turf/closed/wall/trek{icon_state = "black2"; dir = 2},/area/ship/mirandaDIY)
"bY" = (/turf/closed/wall/trek{icon_state = "jeffriestube"; dir = 5},/area/ship/mirandaDIY)
"bZ" = (/obj/machinery/door/airlock/trek/tng/jeffries,/obj/structure/cable/white{icon_state = "1-2"},/obj/machinery/atmospherics/pipe/simple/orange/hidden{icon_state = "intact"; dir = 1},/obj/structure/catwalk,/turf/open/floor/plating,/area/ship/mirandaDIY)
"ca" = (/turf/closed/wall/trek{icon_state = "jeffriestube"; dir = 9},/area/ship/mirandaDIY)
"cb" = (/obj/structure/cable/white{icon_state = "2-8"},/turf/open/floor/plating,/area/ship/mirandaDIY)
"cd" = (/turf/open/floor/plating,/area/ship/mirandaDIY)
"ce" = (/obj/structure/catwalk,/obj/machinery/atmospherics/pipe/simple/cyan/hidden{icon_state = "intact"; dir = 6},/turf/open/floor/plating,/area/ship/mirandaDIY)
"cf" = (/obj/structure/catwalk,/obj/machinery/atmospherics/pipe/simple/cyan/hidden{icon_state = "intact"; dir = 8},/turf/open/floor/plating,/area/ship/mirandaDIY)
"cg" = (/obj/structure/catwalk,/obj/machinery/atmospherics/pipe/simple/cyan/hidden{icon_state = "intact"; dir = 10},/turf/open/floor/plating,/area/ship/mirandaDIY)
"ch" = (/obj/machinery/atmospherics/pipe/simple/cyan/hidden{icon_state = "intact"; dir = 1},/obj/machinery/space_battle/shield_generator,/turf/open/floor/plating,/area/ship/mirandaDIY)
"ci" = (/turf/closed/wall/trek{icon_state = "jeffriestube"; dir = 10},/area/ship/mirandaDIY)
"cj" = (/turf/closed/wall/trek{icon_state = "jeffriestube"; dir = 4},/area/ship/mirandaDIY)
"ck" = (/turf/closed/wall/trek{icon_state = "jeffriestube"; dir = 6},/area/ship/mirandaDIY)
"cl" = (/obj/machinery/atmospherics/pipe/simple/orange/hidden,/obj/structure/catwalk,/obj/structure/cable/white{icon_state = "1-2"},/turf/open/floor/plating,/area/ship/mirandaDIY)
"cm" = (/obj/machinery/atmospherics/components/unary/tank/toxins,/turf/open/floor/plating,/area/ship/mirandaDIY)
"cn" = (/obj/structure/catwalk,/obj/structure/cable/white{icon_state = "2-4"},/turf/open/floor/plating,/area/ship/mirandaDIY)
"co" = (/obj/machinery/power/warpcore/massive{icon_state = "galaxy"},/obj/machinery/atmospherics/components/binary/pump/on,/obj/structure/cable/white{icon_state = "0-8"},/turf/open/floor/plating,/area/ship/mirandaDIY)
"cp" = (/obj/machinery/atmospherics/pipe/simple/cyan/hidden{icon_state = "intact"; dir = 1},/turf/open/floor/plating,/area/ship/mirandaDIY)
"cs" = (/obj/machinery/atmospherics/pipe/simple/orange/hidden{icon_state = "intact"; dir = 8},/obj/structure/catwalk,/obj/structure/cable/white{icon_state = "4-8"},/turf/open/floor/plating,/area/ship/mirandaDIY)
"ct" = (/obj/machinery/atmospherics/pipe/simple/orange/hidden{icon_state = "intact"; dir = 9},/obj/structure/catwalk,/obj/structure/cable/white{icon_state = "1-8"},/turf/open/floor/plating,/area/ship/mirandaDIY)
"cu" = (/obj/structure/catwalk,/obj/structure/cable/white{icon_state = "1-2"},/turf/open/floor/plating,/area/ship/mirandaDIY)
"cv" = (/obj/structure/catwalk,/obj/machinery/atmospherics/pipe/simple/orange/hidden,/turf/open/floor/plating,/area/ship/mirandaDIY)
"cw" = (/obj/structure/catwalk,/obj/machinery/atmospherics/pipe/simple/cyan/hidden{icon_state = "intact"; dir = 1},/turf/open/floor/plating,/area/ship/mirandaDIY)
"cx" = (/turf/closed/wall/trek{icon_state = "jeffriestube"; dir = 8},/area/ship/mirandaDIY)
"cS" = (/obj/machinery/atmospherics/pipe/simple/cyan/hidden{icon_state = "intact"; dir = 5},/turf/open/floor/plating,/area/ship/mirandaDIY)
"cT" = (/obj/machinery/atmospherics/pipe/simple/cyan/hidden{icon_state = "intact"; dir = 9},/turf/open/floor/plating,/area/ship/mirandaDIY)
"cU" = (/obj/structure/cable/white{icon_state = "1-2"},/turf/open/floor/plating,/area/ship/mirandaDIY)
"cZ" = (/obj/structure/cable/white{icon_state = "2-4"},/turf/open/floor/plating,/area/ship/mirandaDIY)
"da" = (/obj/structure/cable/white{icon_state = "2-4"},/obj/structure/cable/white{icon_state = "4-8"},/turf/open/floor/plating,/area/ship/mirandaDIY)
"db" = (/obj/structure/cable/white{icon_state = "1-8"},/turf/open/floor/plating,/area/ship/mirandaDIY)
"dc" = (/obj/machinery/door/airlock/trek/tng/jeffries,/turf/open/floor/trek,/area/ship/mirandaDIY)
"dj" = (/obj/structure/torpedo_launcher,/turf/open/floor/plating,/area/ship/mirandaDIY)
"dH" = (/turf/closed/wall/trek{icon_state = "black2"; dir = 4},/area/ship/mirandaDIY)

(1,1,1) = {"
adadababababababababacababababababababababababababababababababababababadad
adaaaeaeaeaeaeaeakalalalalalamaeaeaeaeaeaeaeaeaeaeaeaeaeakalalalalalamadad
adaaaeaeaeaeaeaeakcdcdcdcdcdamaeaeaeaeaeaeaeaeaeaeaeaeaeakaoapaqarasamadad
adaaaeaeaeaeaeaeakagafcdcdahamaeaeaeaeaeaeaeaeaeaeaeaeaeakaoapaqawasamadad
adaaaeaeaeaeaeaeakcdcdcdcdcdamaeaeaeaeaeaeaeaeaeaeaeaeaeakaoapaqawasamadad
adaaaeakaAaAaAamakcdaucdaxcdamakaAaAaAamaeaeaeaeaeaeaeaeakaoapaBawasamadad
adaaaeakcdaicdamakcdcdcdcdcdamakcdcdcdamaeaeaeaeaeaeaeaeakaoapaHaIasamadad
adaaaeakcdcdcdamakcdajcdcdcdamakcdcdcdamakaPalaQalaRamaeakaSaTayaMaSamadad
adaaaeakcdcdcdamakcdcdcdcdcdamakcdcdcdamakbcbdbebdbfamaeakbgbebhbibjamadad
adaaaeakalcdalalalalcdblcdalalalalcdalamakbmbebebebmamaeakbnbobpbobqamadad
adaaaeakcdcdcdcdcdcdcdcdcdcdcdcdcdcdcdamakbubvbwbxbyamaeakbzbAbBbAbCamadad
adaaaeakcdcdcdcdcdcdcdcdcdcdcdcdcdcdcdambIalbJbKbJalbLaeakbMbNbObPbMamadad
adaaaeakcdcdcdcdanavcdcdcdalaUcdcdcdcdamaeaeasbVaoaebWbWbXbabYbZcababLadad
adaaaeakcdcdcdaKcdbececfcgbecdcdcdcdcdamaeaeasazcicjcjcjcjcjckclaoaeaeadad
adaaaeakcdcdcdaWcdcncocdcpbecdcdcdcdcdamaeaeasaCaDaDaDaDcscscsctaoaeaeadad
adaaaeakcdcdcdcdcdcucvbecwbecdcdcdcdcdamaeaeasaJcacxcxcxcxcxcxcxaeaeaeadad
adaaaaakcdcdcdcdcdaXbRbSbTbScbcdcdcdcdalalalalaEalalalalalamaaaaaaaaaaadad
adaaaaakcdcdcdcdcdcdbtcdchcmaFbSbSbSbSbSbSbSbSdbcdcdcdcdcdamaaaaaaaaaaadad
adaaaaakcdcdcdcdaGaLcdcdcScTcUcdcdcdcdcdcdcdcdcdcdcdcdcdcdamaaaaaaaaaaadad
adaaaaakcdcdcdcdcdcdcdcdcZdadbcdcdcdcdbQbUalaldcalalalalalamaaaaaaaaaaadad
adaaaaakcdcdcdcdcdcdcdcdaNatcdcdcdcdcdamakcdcdcdcdcdcdcdcdamaaaaaaaaaaadad
adaaaaakcdcdcdcdcdcdcdcdcddjcdcdcdcdcdamakcdcdcdcdcdcdcdcdamaaaaaaaaaaadad
adaaaaakcdcdcdcdcdcdcdcdcdcdcdcdcdcdcdamakcdcdcdcdcdcdcdcdamaaaaaaaaaaadad
adaaaaakcdcdcdcdcdcdcdcdcdcdcdcdcdcdcdamakcdcdcdcdcdcdcdcdamaaaaaaaaaaadad
adaaaaakcdcdcdcdcdcdcdcdcdcdcdcdcdcdcdamakcdcdcdcdcdcdcdcdamaaaaaaaaaaadad
adaaaaakcdcdcdcdcdcdcdcdcdcdcdcdcdcdcdamakcdbscdcdcdcdcdcdamaaaaaaaaaaadad
adaaaaakcdcdcdcdcdcdcdcdcdcdcdcdcdcdcdamakcdcdcdcdcdcdcdcdamaaaaaaaaaaadad
adaaaaakcdcdcdcdcdcdcdcdcdcdcdcdcdcdcdambXbababababababababLaaaaaaaaaaadad
adaaaadHbababUcdcdcdcdcdcdcdcdcdbQbababLaaaaaaaaaaaaaaaaaaaaaaaaaaaaaaadad
adadadadadadbXbabababababababababLadadadadadadadadadadadadadadadadadadadad
"}
