"aa" = (/turf/open/space/basic,/area/space)
"ab" = (/turf/closed/wall/ship/steel,/area/ship/nanotrasen)
"ac" = (/obj/machinery/door/airlock/titanium,/turf/open/floor/mineral/titanium,/area/ship/nanotrasen)
"ad" = (/obj/structure/shuttle/engine/propulsion/left{dir = 8},/turf/open/floor/plating/airless,/area/ship/nanotrasen)
"ae" = (/turf/open/floor/mineral/titanium,/area/ship/nanotrasen)
"af" = (/obj/effect/turf_decal/stripes/line,/turf/open/floor/mineral/titanium,/area/ship/nanotrasen)
"ag" = (/obj/effect/turf_decal/stripes/line{dir = 1},/turf/open/floor/mineral/titanium,/area/ship/nanotrasen)
"ah" = (/obj/structure/shuttle/engine/propulsion{dir = 8},/turf/open/floor/plating/airless,/area/ship/nanotrasen)
"ai" = (/obj/structure/shuttle/engine/heater{dir = 8},/obj/structure/window/reinforced{dir = 4},/turf/open/floor/plating/airless,/area/ship/nanotrasen)
"aj" = (/obj/machinery/trek/transporter,/obj/item/device/tricorder,/turf/open/floor/mineral/titanium,/area/ship/nanotrasen)
"ak" = (/obj/machinery/computer/pod{id = "oldship_ruin_gun"},/obj/structure/catwalk,/turf/open/floor/mineral/titanium,/area/ship/nanotrasen)
"al" = (/turf/open/floor/plating,/area/ship/nanotrasen)
"am" = (/obj/structure/fluff/warpcore,/turf/open/floor/mineral/titanium,/area/ship/nanotrasen)
"an" = (/obj/effect/turf_decal/stripes/line{dir = 4},/turf/open/floor/mineral/titanium,/area/ship/nanotrasen)
"ao" = (/obj/machinery/door/airlock/glass,/turf/open/floor/plating,/area/ship/nanotrasen)
"ap" = (/obj/machinery/mass_driver{dir = 4; icon_state = "mass_driver"; id = "oldship_ruin_gun"},/turf/open/floor/plating,/area/ship/nanotrasen)
"aq" = (/obj/machinery/door/poddoor{id = "oldship_ruin_gun"; name = "pod bay door"},/turf/open/floor/plating,/area/ship/nanotrasen)
"ar" = (/obj/structure/shuttle/engine/propulsion/right{dir = 8},/turf/open/floor/plating/airless,/area/ship/nanotrasen)
"as" = (/obj/machinery/space_battle/shield_generator,/turf/closed/wall/ship/steel,/area/ship/nanotrasen)
"at" = (/obj/machinery/computer/camera_advanced/transporter_control{dir = 8},/turf/open/floor/mineral/titanium,/area/ship/nanotrasen)
"au" = (/obj/machinery/door/airlock/titanium,/turf/open/floor/plating,/area/ship/nanotrasen)
"av" = (/obj/structure/overmap/ship/nanotrasen,/turf/open/floor/mineral/titanium,/area/ship/nanotrasen)
"aw" = (/obj/effect/turf_decal/stripes/line{dir = 8},/turf/open/floor/mineral/titanium,/area/ship/nanotrasen)
"ax" = (/obj/structure/table,/obj/item/storage/firstaid/regular{pixel_x = 6; pixel_y = -5},/obj/item/device/tricorder,/obj/item/scalpel,/turf/open/floor/mineral/titanium,/area/ship/nanotrasen)
"ay" = (/obj/machinery/computer/shipcomms{ship_name = "NSV Muffin"},/obj/structure/catwalk,/obj/machinery/light{dir = 1},/turf/open/floor/mineral/titanium,/area/ship/nanotrasen)
"az" = (/obj/structure/chair{dir = 1},/turf/open/floor/mineral/titanium,/area/ship/nanotrasen)
"aA" = (/obj/structure/window/trek/steel{dir = 4},/turf/open/floor/mineral/titanium,/area/ship/nanotrasen)
"aB" = (/obj/structure/chair{dir = 4},/obj/effect/turf_decal/stripes/line{dir = 8},/turf/open/floor/mineral/titanium,/area/ship/nanotrasen)
"aC" = (/obj/structure/catwalk,/turf/open/floor/mineral/titanium,/area/ship/nanotrasen)
"aD" = (/obj/effect/landmark/shield,/turf/open/space/basic,/area/ship/nanotrasen)
"aE" = (/obj/machinery/door/airlock/titanium,/obj/structure/catwalk,/turf/open/floor/mineral/titanium,/area/ship/nanotrasen)
"aF" = (/obj/structure/window/trek/steel,/turf/open/floor/plating,/area/ship/nanotrasen)
"aG" = (/obj/machinery/portable_atmospherics/scrubber,/obj/item/grenade/chem_grenade/metalfoam,/obj/item/grenade/chem_grenade/smart_metal_foam,/turf/open/floor/mineral/titanium,/area/ship/nanotrasen)
"aH" = (/obj/machinery/computer/camera_advanced/shuttle_docker/whiteship/ruin{view_range = 18},/obj/structure/catwalk,/turf/open/floor/mineral/titanium,/area/ship/nanotrasen)
"aI" = (/obj/structure/table,/turf/open/floor/mineral/titanium,/area/ship/nanotrasen)
"aJ" = (/obj/structure/table,/obj/item/gun/energy/laser/retro,/turf/open/floor/mineral/titanium,/area/ship/nanotrasen)
"aK" = (/obj/machinery/door/airlock/glass,/turf/open/floor/mineral/titanium,/area/ship/nanotrasen)
"aL" = (/obj/machinery/door/airlock/glass,/obj/structure/catwalk,/turf/open/floor/mineral/titanium,/area/ship/nanotrasen)
"aO" = (/obj/machinery/light{dir = 4},/obj/structure/fluff/helm/desk/tactical/nanotrasen{icon_state = "computer"; dir = 8},/turf/open/floor/mineral/titanium,/area/ship/nanotrasen)
"aP" = (/obj/machinery/portable_atmospherics/canister/oxygen,/obj/item/grenade/chem_grenade/metalfoam,/turf/open/floor/mineral/titanium,/area/ship/nanotrasen)
"aQ" = (/obj/structure/frame/computer{anchored = 1},/obj/structure/light_construct,/obj/machinery/light,/obj/structure/catwalk,/turf/open/floor/mineral/titanium,/area/ship/nanotrasen)
"aR" = (/obj/structure/sign/nanotrasen,/turf/closed/wall/ship/steel,/area/ship/nanotrasen)
"aS" = (/obj/machinery/vending/sustenance,/turf/open/floor/mineral/titanium,/area/ship/nanotrasen)
"aT" = (/obj/machinery/vending/tool,/turf/open/floor/mineral/titanium,/area/ship/nanotrasen)
"aU" = (/obj/item/clothing/suit/space/hardsuit/medical,/obj/item/clothing/suit/space/hardsuit/medical,/obj/item/clothing/mask/breath,/obj/item/clothing/mask/breath,/obj/item/device/radio/off,/obj/structure/table,/obj/item/storage/toolbox/mechanical,/obj/item/tank/internals/emergency_oxygen,/obj/item/tank/internals/emergency_oxygen,/obj/item/tank/internals/emergency_oxygen,/obj/item/tank/internals/emergency_oxygen,/obj/item/tank/internals/emergency_oxygen,/turf/open/floor/mineral/titanium,/area/ship/nanotrasen)
"aX" = (/obj/structure/chair,/turf/open/floor/mineral/titanium,/area/ship/nanotrasen)
"aY" = (/obj/structure/window/trek/steel{dir = 4},/turf/open/floor/plating,/area/ship/nanotrasen)
"bc" = (/obj/structure/frame/computer{anchored = 1},/turf/open/floor/mineral/titanium,/area/ship/nanotrasen)

(1,1,1) = {"
aDaaaaaaaaaaaaaaaaaaaaaaaaaaaaaaaaaaaaaaaaaaaaaaaaaaaaaaaaaD
aDaaaaaaaaaaaaaaaaaaaaaaaaaaaaaaaaaaaaaaaaaaaaaaaaaaaaaaaaaD
aDaaaaaaaaaaaaaaaaaaaaaaaaaaaaaaaaaaaaaaaaaaaaaaaaaaaaaaaaaD
aDaaaaaaaaaaaaaaaaaaaaaaaaaaaaaaaaaaaaaaaaaaaaaaaaaaaaaaaaaD
aDaaaaaaaaaaaaaaaaababaaaaaaaaaaaaabacabaAaAaAaAacabaaaaaaaD
aDaaaaaaaaaaaaaaaaadababaaaaaaaaababaCaCaCaCaCaCaCabaaaaaaaD
aDaaaaaaaaaaaaaaaaahaiababaaababaeabaCaeaeaeaeaeakabababaaaD
aDaaaaaaaaaaaaaaaaahaialabababaCaCabaCaeaeaeaeaCaCaoapaqaaaD
aDaaaaaaaaaaaaaaaaahaialalabaCaCaeabaCaeaeaeaCabaRababababaD
aDaaaaaaaaaaaaaaaaarabalalauaCaeaeabaCaCaCaCaCabaCayaHaCabaD
aDaaaaaaaaaaaaaaaaaaababababaCaeaeababaRabacababaeazazaeabaD
aDaaaaaaaaaaaaaaaaababaCaCabaCaeafafafafafaeaCabaeaeaeaeaFaD
aDabaAaAaAabaaaaababaCaeaCabaCanabababacabawaCabaeaeaeaeaFaD
aDabaTaSaSababababaCaeaeaCaFaCanabaeaeaeabawaCaFaeaeaIaJaFaD
aDabaCaCaCaEaCaEaCawaeaeaCaKaCanabaeaeaeasawaCaLavaeaBaOaFaD
aDabaGaPaUababababaCaeaeaCaFaCanabamaeaeabawaCaFaeaeaIaIaFaD
aDabaAaAaAabaaaaababaCaeaCabaCanabaeaeaeabawaCabaeaeaeaeaFaD
aDaaaaaaaaaaaaaaaaababaCaCabaCanabacabaRabawaCabaeaeaeaeaFaD
aDaaaaaaaaaaaaaaaaaaababababaCaeagagagagagaeaCabaeaXaeaeabaD
aDaaaaaaaaaaaaaaaaadabalalauaCaeaCaCaCaCaCaCaCabaCaQaCaCabaD
aDaaaaaaaaaaaaaaaaahaialalabaCaCabacababaYaYaYababababababaD
aDaaaaaaaaaaaaaaaaahaialabababaeabaeaeaeaeaeaeaeaeaeababaaaD
aDaaaaaaaaaaaaaaaaahaiababaaabababaeaxaeaeaeaeaebcababaaaaaD
aDaaaaaaaaaaaaaaaaarababaaaaaaaaabababaeaeajataeababaaaaaaaD
aDaaaaaaaaaaaaaaaaababaaaaaaaaaaaaaaababababababaaaaaaaaaaaD
aDaaaaaaaaaaaaaaaaaaaaaaaaaaaaaaaaaaaaaaaaaaaaaaaaaaaaaaaaaD
aDaaaaaaaaaaaaaaaaaaaaaaaaaaaaaaaaaaaaaaaaaaaaaaaaaaaaaaaaaD
aDaaaaaaaaaaaaaaaaaaaaaaaaaaaaaaaaaaaaaaaaaaaaaaaaaaaaaaaaaD
aDaaaaaaaaaaaaaaaaaaaaaaaaaaaaaaaaaaaaaaaaaaaaaaaaaaaaaaaaaD
aDaaaaaaaaaaaaaaaaaaaaaaaaaaaaaaaaaaaaaaaaaaaaaaaaaaaaaaaaaD
"}
