"a" = (/obj/effect/landmark/shield,/turf/open/space/basic,/area/ship/nanotrasen)
"b" = (/turf/open/space/basic,/area/space)
"c" = (/turf/closed/wall/ship/steel,/area/ship/nanotrasen)
"d" = (/obj/machinery/door/airlock/titanium,/turf/open/floor/mineral/titanium,/area/ship/nanotrasen)
"e" = (/obj/structure/window/trek/steel{dir = 4},/turf/open/floor/mineral/titanium,/area/ship/nanotrasen)
"f" = (/obj/structure/shuttle/engine/propulsion/left{dir = 8},/turf/open/floor/plating/airless,/area/ship/nanotrasen)
"g" = (/obj/structure/catwalk,/turf/open/floor/mineral/titanium,/area/ship/nanotrasen)
"h" = (/obj/structure/shuttle/engine/propulsion{dir = 8},/turf/open/floor/plating/airless,/area/ship/nanotrasen)
"i" = (/obj/structure/shuttle/engine/heater{dir = 8},/obj/structure/window/reinforced{dir = 4},/turf/open/floor/plating/airless,/area/ship/nanotrasen)
"j" = (/turf/open/floor/mineral/titanium,/area/ship/nanotrasen)
"k" = (/obj/machinery/computer/pod{id = "oldship_ruin_gun"},/obj/structure/catwalk,/turf/open/floor/mineral/titanium,/area/ship/nanotrasen)
"l" = (/turf/open/floor/plating,/area/ship/nanotrasen)
"m" = (/obj/machinery/door/airlock/glass,/turf/open/floor/plating,/area/ship/nanotrasen)
"n" = (/obj/machinery/mass_driver{dir = 4; icon_state = "mass_driver"; id = "oldship_ruin_gun"},/turf/open/floor/plating,/area/ship/nanotrasen)
"o" = (/obj/machinery/door/poddoor{id = "oldship_ruin_gun"; name = "pod bay door"},/turf/open/floor/plating,/area/ship/nanotrasen)
"p" = (/obj/structure/sign/nanotrasen,/turf/closed/wall/ship/steel,/area/ship/nanotrasen)
"q" = (/obj/structure/shuttle/engine/propulsion/right{dir = 8},/turf/open/floor/plating/airless,/area/ship/nanotrasen)
"r" = (/obj/machinery/door/airlock/titanium,/turf/open/floor/plating,/area/ship/nanotrasen)
"s" = (/obj/machinery/computer/shipcomms{ship_name = "NSV Muffin"},/obj/structure/catwalk,/obj/machinery/light{dir = 1},/turf/open/floor/mineral/titanium,/area/ship/nanotrasen)
"t" = (/obj/machinery/computer/camera_advanced/shuttle_docker/whiteship/ruin{view_range = 18},/obj/structure/catwalk,/turf/open/floor/mineral/titanium,/area/ship/nanotrasen)
"u" = (/obj/structure/chair{dir = 1},/turf/open/floor/mineral/titanium,/area/ship/nanotrasen)
"v" = (/obj/effect/turf_decal/stripes/line,/turf/open/floor/mineral/titanium,/area/ship/nanotrasen)
"w" = (/obj/structure/window/trek/steel,/turf/open/floor/plating,/area/ship/nanotrasen)
"x" = (/obj/effect/turf_decal/stripes/line{dir = 4},/turf/open/floor/mineral/titanium,/area/ship/nanotrasen)
"y" = (/obj/effect/turf_decal/stripes/line{dir = 8},/turf/open/floor/mineral/titanium,/area/ship/nanotrasen)
"z" = (/obj/machinery/vending/tool,/turf/open/floor/mineral/titanium,/area/ship/nanotrasen)
"A" = (/obj/machinery/vending/sustenance,/turf/open/floor/mineral/titanium,/area/ship/nanotrasen)
"B" = (/obj/structure/table,/turf/open/floor/mineral/titanium,/area/ship/nanotrasen)
"C" = (/obj/structure/table,/obj/item/gun/energy/laser/retro,/turf/open/floor/mineral/titanium,/area/ship/nanotrasen)
"D" = (/obj/machinery/door/airlock/titanium,/obj/structure/catwalk,/turf/open/floor/mineral/titanium,/area/ship/nanotrasen)
"E" = (/obj/structure/catwalk,/obj/machinery/power/ship/phaser,/turf/open/floor/mineral/titanium,/area/ship/nanotrasen)
"F" = (/obj/machinery/door/airlock/glass,/turf/open/floor/mineral/titanium,/area/ship/nanotrasen)
"G" = (/obj/machinery/space_battle/shield_generator,/turf/closed/wall/ship/steel,/area/ship/nanotrasen)
"H" = (/obj/machinery/door/airlock/glass,/obj/structure/catwalk,/turf/open/floor/mineral/titanium,/area/ship/nanotrasen)
"I" = (/obj/structure/overmap/ship/nanotrasen,/turf/open/floor/mineral/titanium,/area/ship/nanotrasen)
"J" = (/obj/structure/chair{dir = 4},/obj/effect/turf_decal/stripes/line{dir = 8},/turf/open/floor/mineral/titanium,/area/ship/nanotrasen)
"K" = (/obj/machinery/light{dir = 4},/obj/structure/fluff/helm/desk/tactical/nanotrasen{icon_state = "computer"; dir = 8},/turf/open/floor/mineral/titanium,/area/ship/nanotrasen)
"L" = (/obj/machinery/portable_atmospherics/scrubber,/obj/item/grenade/chem_grenade/metalfoam,/obj/item/grenade/chem_grenade/smart_metal_foam,/turf/open/floor/mineral/titanium,/area/ship/nanotrasen)
"M" = (/obj/machinery/portable_atmospherics/canister/oxygen,/obj/item/grenade/chem_grenade/metalfoam,/turf/open/floor/mineral/titanium,/area/ship/nanotrasen)
"N" = (/obj/item/clothing/suit/space/hardsuit/medical,/obj/item/clothing/suit/space/hardsuit/medical,/obj/item/clothing/mask/breath,/obj/item/clothing/mask/breath,/obj/item/device/radio/off,/obj/structure/table,/obj/item/storage/toolbox/mechanical,/obj/item/tank/internals/emergency_oxygen,/obj/item/tank/internals/emergency_oxygen,/obj/item/tank/internals/emergency_oxygen,/obj/item/tank/internals/emergency_oxygen,/obj/item/tank/internals/emergency_oxygen,/turf/open/floor/mineral/titanium,/area/ship/nanotrasen)
"O" = (/obj/structure/fluff/warpcore,/turf/open/floor/mineral/titanium,/area/ship/nanotrasen)
"P" = (/obj/machinery/power/ship/phaser,/turf/closed/wall/ship/steel,/area/ship/nanotrasen)
"Q" = (/obj/effect/turf_decal/stripes/line{dir = 1},/turf/open/floor/mineral/titanium,/area/ship/nanotrasen)
"R" = (/obj/structure/chair,/turf/open/floor/mineral/titanium,/area/ship/nanotrasen)
"S" = (/obj/structure/frame/computer{anchored = 1},/obj/structure/light_construct,/obj/machinery/light,/obj/structure/catwalk,/turf/open/floor/mineral/titanium,/area/ship/nanotrasen)
"T" = (/obj/structure/window/trek/steel{dir = 4},/turf/open/floor/plating,/area/ship/nanotrasen)
"U" = (/obj/structure/table,/obj/item/storage/firstaid/regular{pixel_x = 6; pixel_y = -5},/obj/item/device/tricorder,/obj/item/scalpel,/turf/open/floor/mineral/titanium,/area/ship/nanotrasen)
"V" = (/obj/structure/frame/computer{anchored = 1},/turf/open/floor/mineral/titanium,/area/ship/nanotrasen)
"W" = (/obj/machinery/trek/transporter,/obj/item/device/tricorder,/turf/open/floor/mineral/titanium,/area/ship/nanotrasen)
"X" = (/obj/machinery/computer/camera_advanced/transporter_control{dir = 8},/turf/open/floor/mineral/titanium,/area/ship/nanotrasen)

(1,1,1) = {"
abbbbbbbbbbbbbbbbbbbbbbbbbbbba
abbbbbbbbbbbbbbbbbbbbbbbbbbbba
abbbbbbbbbbbbbbbbbbbbbbbbbbbba
abbbbbbbbbbbbbbbbbbbbbbbbbbbba
abbbbbbbbccbbbbbbcdceeeedcbbba
abbbbbbbbfccbbbbccgggggggcbbba
abbbbbbbbhiccbccjcgjjjjjkcccba
abbbbbbbbhilcccggcgjjjjggmnoba
abbbbbbbbhillcggjcgjjjgcpcccca
abbbbbbbbqcllrgjjcgggggcgstgca
abbbbbbbbbccccgjjccpcdccjuujca
abbbbbbbbccggcgjvvvvvjgcjjjjwa
aceeecbbccgjgcgxcccdcygcjjjjwa
aczAAccccgjjgwgxcjjjcygwjjBCwa
acgggDgDEyjjgFgxcjjjGygHIjJKwa
acLMNccccgjjgwgxcOjjcygwjjBBwa
aceeecbbPcgjgcgxcjjjcygcjjjjwa
abbbbbbbbccggcgxcdcpcygcjjjjwa
abbbbbbbbbccccgjQQQQQjgcjRjjca
abbbbbbbbfcllrgjgggggggcgSggca
abbbbbbbbhillcggcdccTTTcccccca
abbbbbbbbhilcccjcjjjjjjjjjccba
abbbbbbbbhiccbcccjUjjjjjVccbba
abbbbbbbbqccbbbbcccjjWXjccbbba
abbbbbbbbccbbbbbbbccccccbbbbba
abbbbbbbbbbbbbbbbbbbbbbbbbbbba
abbbbbbbbbbbbbbbbbbbbbbbbbbbba
abbbbbbbbbbbbbbbbbbbbbbbbbbbba
abbbbbbbbbbbbbbbbbbbbbbbbbbbba
abbbbbbbbbbbbbbbbbbbbbbbbbbbba
"}
