"a" = (/turf/closed/mineral/volcanic,/area/overmap/system)
"c" = (/turf/open/floor/fakespace,/area/overmap/system)

(1,1,1) = {"
aaaaaaaaaaaaaaaaaaaaaaaaaaaaaaaaaaaaaaaaaaaaaaaaaaaaaaaaaaaaaaaaaaaaaaaaaaaaaaaaaaaaaaaaaaaaaaaaaaaaaaaaaaaaaaaaaaaaaaaaaaaaaaaaaaaaaaaaaaaaaaaaaaaaaa
acccaacaaaaacccccccaaccccccccccccccccccaaaccccccccccccccccaaaaccccccccccccccaaccccccccccaaccccccaaaacccccccccccccccccccccccccccccccccccaaaaaccccccccca
acccaacaaaacccccaaaaaaaaaccccccccccccccaaaaacaccccccccccccaacccaaccacccccccccccccaaaacccaacccaacaaaacaacccccccccccccccaaaccccccccccccccccccccaccccaaca
acccaaccccccccccccccccccccccccccccccccccccccccccccccccccaaccccccccccccccaaaccccccaaaacccccaacccccccccaaccccccccccaaacccccccccccccccaaaacccccccccccccca
acccccaccccaaaacccccccccccccccccccccccccccccccccccccccccccccccccccccccccaaaccccccaaaacccccaccccccccccccccccccccccaaacccccccccaaaaccaaaacccccccccccccca
accccccccccaaaaccaacccccccccccccccccccccccccccccccacaaaccccccccccccccccccccccccccccccccccccccccccccccccccccaaacccccccccccccccccccccaaaacccccccccccacca
acccccaccccccccccaacccccccccccccccccccccccccccccccacccccccccccccccccccccccccccccccccccccccccccccccccccccccccccccccccccccccccccccccccccccccccccccccacca
accccccccccccccccaaccccccccccccccccccccccccccccccaacaaccccccccccccccccccccccccccccccccccccccccccccccccccccccccccccccccccccccccccccccccccccacccccccacca
acccccccaacccccccaacccccccccccccccccccccccccccccaaccccccccccccccccccccccccccccccccccccccccccccccccccccccccccccccccccccccccccccccccccccccccacccccaaacca
acccccccaaccccccccccccccccccccccccccccccccccccccaaacacccccccccccccccccccccccccccccccccccccccccccccccccccccccccccccccccccccccccccccccccccccccccccccccca
accccccccccccccccccccccccccccccccccccccccccccccccaacaccccccccccccccccccccccccccccccccccccccccccccccccccccccccccccccccccccccccccccccacaccccccaccccaccca
accccccccccccccccccccccccccccccccccccccccccccccccccccccccccccccccccccccccccccccccccccccccccccccccccccccccccccccccccccccccccccccccacacccacccccccccaccca
acccccccccaaaccccccccccccccccccccccccccccccccccccccccccccccccccccccccccccccccccccccccccccccccccccccccccccccccccccccccccccccccccccacccccccccccccaacccca
acccccaaacaaacccccccccccccccccccccccccccccccccccccccccccccccccccccccccccccccccccccccccccccccccccccccccccccccccccccccccccccccccccccccccccccccccccccccca
acccccccccaaacaacccccccccccccccccccccccccccccccccccccaccccccccccccccccccccccccccccccccccccccccccccccccccccccccccccccccccccccccccccccccccccccccccccccca
acccccccccccccccccccccccccccccccccccccccccccccccccccccccccccccccccccccccccccccccccccccccccccccccccccccccccccccccccccccccccccccccccccccccaaccccccccccca
acccccccccccccccccccccccccccccccccccccccccccccccccccccccccccccccccccccccccccccccccccccccccccccccccccccccccccccccccccccccccccccccccccccccaaccccccccccca
acccccccccccccccccccccccccccccccccccccccccccccccccccccccccccccccccccccccccccccccccccccccccccccccccccccccccccccccccccccccccccccccccccccccccccacccccccca
acccccccccccccccccccccccccccccccccccccccccccccccccccccccccccccccccccccccccccccccccccccccccccccccccccccccccccccccccccccccccccccccccccccccccaacccccaccaa
accacccccccccccccccccccccccccccccccccccccccccccccccccccccccccccccccccccccccccccccccccccccccccccccccccccccccccccccccccccccccccccccccccccacccaccccccccaa
accaccccccccccccccccccccccccccccccccccccccccccccccccccccccccccccccccccccccccccccccccccccccccccccccccccccccccccccccccccccccccccccccccccccccccccccccccca
accaccccccccccccccccccccccccccccccccccccccccccccccccccccccccccccccccccccccccccccccccccccccccccccccccccccccccccccccccccccccccccccccccccaccaccccccccccca
accccccccccccccccccccccccccccccccccccccccccccccccccccccccccccccccccccccccccccccccccccccccccccccccccccccccccccccccccccccccccccccccccccccccccccccccaccca
accccaaaaccccccacccccccccccccccccccccccccccccccccccccccccccccccccccccccccccccccacccccaaccccccccccccccccccccccccccccccccccccccccccccccccccccccccccacaaa
acaccaaaaccccccacaaccccccccccccccccccccccccccccccccccccccccccccccccccccccaaccccaccaccccccccccccccccccccccccccccccccccccccccccccccccccccccccccccccaccca
acaccccccccccccacaaccccccccccccccccccccccccccccccccccccccccccccccccccccccccaaaaaacccccccccccccccccccccccccccccccccccccccccccccccccccccccccccccccccccca
acaccccccccccccaccccccccaaaccccccccccccccccccccccccccccccccccccccccccccccccaaaaaacccacccccccccccccccccccccccccccccccccccccccccccccccccccccccacccccccaa
acccccccccccccccccccccccaaaaaccacccccccccccccccccccccccccccccccccccccccccccaaaaaacccacccccccccccccccccccccccccccccccccccccccccccccccccccccccccaaacccca
accccccccccccaaacccccccccccaaccaaaaccccccccccccccccccccccccccccccccccccccccaaaaaaaaaacccccccccccccccccccccccccccccccccccccccccccccccccccccccccccccccca
acccccccccccccccccccccccccccaaaaaaaccccccccccccaaccccccccccccccccccccccccccacccaccccccccccccccccccccccccccccccccccccccccccccccccccccccccccccccccccacca
acccccccccccccccccccccccccccaaaaaccccccccaaacccaaccccccccccccccccccccccccccacaaaaccccccccccccccccccccccccccccccccccccccccccccccccccccccccccccaaaaaacca
acccccccccccccccccccccccccccaaaaaccaacccccccccccccccccccccccccccccccccccccccccccccccccccccccccccccccccccccccccccccccccccccccccccccccccccccccccccccccca
accccccccccccccccccccccccccccccccccaacccccccccccccccccccccccccccccccccccccccccccccccccccccccccccccccccccccccccccccccccccccccccccccccccccaaccccccccccca
accccccccccaccccccccccccccccccccccccccacccccccccccccccccccccccccccccccccccccccccccccccccccccccccccccccccccccccccccccccccccccccccccccccccccccccccccccca
acccaaaacccccaaacccccaacccccccccccccccccaaaaaaaccccccccccccccccccccccccccccccccccccccccccccccccccccccccccccccccccccccccccccccccccccccccccccccccccccaaa
acccaaaacccccaaacccccaacccccccccccccccccaaaaaaaccccccccccccccccccccccccccccccccccccccccccccccccccccccccccccccccccccccccccccccccccccccccccccaaccccccaaa
acccaaaaccccccccaaacccccccccccaacccccccccccccaacccccccccccccccccccccccccccccccccccccccccccccccccccccccccccccccccccccccccccccccccccccccccccccccccaaccca
accccccaacccccccccccccccccccccaacccccccccccccaacccccccccccccccccccccccccccccccccccccccccccccccccccccccccccccccccccccccccccccccccccccccccccccccccccccca
accccccaacccccccccccccccccccccaaccccccccccccccccacccccccccccccccccccccccccccccccccccccccccccccccccccccccccccccccccccccccccccccccccccccccccccccccccccaa
accccacccccccccccccccccccccaaaccccccaaccccccccccccccaaccccccccccccccccccccccccccccccccccccccccccccccccccccccccccccccccccccccccccccccccccccccccccccccca
acccccccaaccccccccccccccaacaaaccccccaacccccccccaccccaaccccccccccccccccccccccccccccccccccccccccccccccccccccccccccccccccccccccccccccccccccccccccccccccca
acccccccccccccccccccccccaaccccccccccaacccccccccaccccccccccccccccccccccccccccccccccccccccccccccccccccccccccccccccccccccccccccccccccccccccccaaaaccccccca
accccccccccaaaaaccccccccccaaacccccccccccaacccccccccccccccccccccccccccccccccccccccccccccccccccccccccccccccccccccccccccccccccccccccccccccccccaaaccccccca
accccccccccaaaaaccccccccccaaacccccccccccaacccccccccccccccccccccccccccccccccccccccccccccccccccccccccccccccccccccccccccccccccccccccccccccccccccccaaaacca
acccccccccccccccccccccccccccccccccccccccccaccccccccccccccccccccccccccccccccccccccccccccccaaacccccccccccccccccccccccccccccccccccccccccccccccccccaaaaaaa
acccccccccccccccccccccccccccccccccccccccccaccccccccccccccccccccccccccccccccccccccccccccccaaacacccccccccccccccccccccccccccccccccccccccccccccccccccccaaa
accccaaccccaaaacccccccccccccccccccccccccccccccaaaaaacaacccccaacccccccccccccccccccccccccccaaaaaaaaaccccccccccccccccccccccccccccccccccccccccccccccccccca
accccaaccacaaaaccacccccccccaccccccccccccccccccaaaaaaccccaaacaacccccccccccccccccccccccccccaaaaaaaaaaaaacccccccccccccccccccccccccccccccccccccccccaccccca
accccaaccccccccccccccccccccaccccccccccccccccccaaaaaacccccccccccccccccccccccccccccccccccccaaaaaaaaaaaaacccccccccccccccccccccccccccccccccaccccccccccccca
acccacccaccccccccccccccccccacccccccccccccccccccccccaaccccccccccccccccccccccccccccccccccccaaaaaaaaaaaaacccccccccccccccccccccccccccccccccccccccaaaaaaaca
accccccccccccccccccccccccccacccccccccccccccccaaaaccccccccccccccccccccccccccccccccccccaaacaaaaaaaaaaaaacccccccccccccccccccccccccccccccccccccccaaaaaaaca
acccccccccccccccccccccccccccccccccccccccccccaaaaaacccaaaaccccccccccccccccccccccccccccaaacaaaaaaaaaaaaaaaccccccccccccccccccccccccccccccccccccccccccccca
acccccccccccccccccccccccccccccacccaaaacccccccaaaacaccaaaaccccccccccccccccccccccccccaaacccaaaaaaaaaaaaaaaccccccccccccccccccccccccccccccccccccccccccacca
acccccccccaaccccccccccccccccccccccaaaacccccccaaaacaccaaaaccccccccccccccccccccccccccccccccaaaaaaaaaaaaaaaccccccccccccccccccccccccccccccccccccccccccccca
acccccccccccccccccccccccaccccaccccaaaaaaacccaacaacccaaaaaccaaaccccccccccccccccccccccccccaaaaaaaaaaaaaaaaccccccccccccccccccccccccccccccccccccccccccccca
acccccccccccccccccccccccccccccccccccccaaacccccccccccaaaaccaaaaaccccccccccccccccccccccccccaaaaaaaaacccccccccccccccccccccccccccccccccccccccccccccccaaaca
acccccccccccccccccccccccccccccccccccccccaccccccccccaaaaaaccccccccccccccccccccccccccccccccaaaaaaaaacccccccccccccccccccccccccccccccccccccccccccccccaaaca
acccccccccccccccccccccccccccccaaccccccccaccccccccccaaaaaacccccccccccccccccccccccccccccccccaacccccccccccccccccccccccccccccccccccccccccccccccccccccaaaaa
acccaaaaaacccccaaccccccccccaccccccccccccaaaaaaccccaaaaaaaaacccaacccccccccccccccccccccccccccccccccccccccccccccccccccccccccccccccccccccccccccccccccaaaca
accaaccccccccccaacccccccccccccccccccccccccccccccccaaaaaaacccccaaccccccccccccccccccccccccccccccccccccccccccccccccccccccccccccccccccccccccccccaaacaaacca
accaaccccccccccccccccccccccccccacccccccccccccccccccaaaaaacccccccccccccccccccccccccccccccccccccccccccccccccccccccccccccccccccccccccccccccccccaaacccccca
acccccccccccccccccacccccaccccccacccccccccccccccccccaaaaaccccccccccccccccccccccccccccccccccccccccccccccccccccccccccccccccccccccccccccccccccccaaacccccca
accccccccccccccccccccccccccaaccccccccccccccccccccccaaaaacccccccccccccccccccccccccccccccccccccccccccccccccccccccccccccccccccccccccccccccccccccccccaaaca
accccccccaaccccccccccccccccccccccaaaccccccccccaacccccccccaaaccccccccccccccccccccccccccccccccccccccccccccccccacaacccccccccccccccccccccccccccccccccaaaca
accccccccccccccccccccccccccccccccccccaaacccccccccccccccccaaaccccccccccccccccccccccccccccccccccccccccccccccccccaaccccccccccccccccccccccccccccccccccaaca
accccacaaaccacccccccccccccccccccccccccccccccccccccccccccccccccccccccccccccccccccccccccccccccccccccccccccccccccccccccccccccccccccccccccccccccccccccccaa
acccccacccccccccccccccccccccccccccccccccccccccccccccccccccccccccccccccccccccccccccccccccccccccccccccccccaccacaacccccccccccccccccccccccccccccccccccccca
accccccccccccccccccccccccccccccccccccccccccccccccccccccccccccccccccccccccccccccccccccccccccccccccccccccccccacaaacccccaccccccccccccccccccccccccccccccca
acccccccccccccccccccccccccccccccccccccccccccccccccccccccccccccccccccccccccccccccccccccccccccccccccccccccccccacaaaaaccccccccccccccccccccccccccaacccccca
acccccccaaccccccccccccccccccccccaccccccccccccccccccccccccccccccccccccacccaaaaaaccaaccaaacaccccccccccccccccccccaaaaaccccccccccccccccccccccccccaaccccaca
accccccccccccccccccccccccccccccccccccccccccccccccccccccccccccccccccccaaccaaaaaacccccccccccccccccccccccaccccccccccccccccccccccccccccccccccccccccccaacca
acccccccccccaaaaacaccccccccccccccacccccccccccccccccccccccccccccccccccaaccaaaaaacccccccccccccccccccccccccaccaaaccccccccccccccccccccccccccccccccacccccca
acccccccccaccaaaacccccccccacccaaaaaaaaacccccccccccccccccccccccccccccccccaaaaaaacccccccccccccccccccaaaccccacaaaacccccccccccccccccccccccccccccccccccccca
acccccccccaaaaaaacacccccccccccaacaaaaaacccccccccccccccccccccccccccccccaacaaaaaacacccccccccccccccccaaaccccaaaaaacccccccccccccccccccccccccccccccccccccca
accccccccaaaaaaaacacccccccccccaaccaaaaacccccccccccccccccccccccccccccccaaccccccccacccccccccccccccccaaaccccccaaaccccccccccccccccccccccccccccccccccccaaaa
accccccccaaaaaaaaaccccccccccccaaaaccccacaaaccccccccccccccccccccccccccccccccaaaacacccccccccccccccacccccccccccccccccccccccccccccccccccccccccccccccccaaaa
accccccccaaaacccccacccccccccccccccccccccaaacccccccccccccccccccccccccccccccccccccccccccccccccccccccccccccccccccccccccccccccccccccccccccccccccccccccccca
accccccccccccaaacccaaccccccccccccaaaccccaaaaccccccccccccccccccccccccccccccccccccccccccccccccccccccccccccccccccccccccccccccccccccccccccccccccccccccccca
accccccccccccaaacccaccccccccccccccccccccaaaaccccccccacccccccccccccccccccccccccccccccccccccccccccccccccccccccccccccccccccccccccccccccccccccccccccccaaaa
accccccccccccaaaaacaccccccccccccccccccccaaaaccccccaacccccccccccccccccccccccccccccccccccccccccccccccccccccccccccccccccccccccccccccccccccccccccccaccccaa
acccaacccccccccaaaacccccccccccccccccccccccccccccccaaccccccccccccccccccccccccccccccccccccccccccccccccccccccccccccccccccccccccccccccccccccccccccccccccaa
acccaacaaaaaacccccccccccccccccccccccccccccccccccccccccccccccccccccccccccccccccccccccccccccccccccccccccccccccccccccccccccccccccccccccccccccccccccccaaca
acccaacaaaacccccccccccccccccccccccccccccccccccccccccccccccccccccccccccccccccccccccccccccccccccccccccccccccccccccccccccccccccccccccccccccccccccccccaaca
acccccccccccccccccccccccccccccccccccccccccccccccccccccccccccccccccccccccccccccccccccccccccccccccccccccccccccccccccccccccccccccccccccccccccccccccccccca
acccacccaaccccccccccccccccccccccccccccccccccccccccccccccccccccccccccccccccccccccccccccccccccccccccccccccccccccccccccccccccccccccccccccccccccccccccccca
acccccccaaccccccccccccccccccccccccccccccccccccccccacccccccccccccccccccccccccccccccccccccccccccccccccccccccccccccccccccccccccccccccccccccccccccccccccca
acccccccccccccccccccccccccccccccccccccccccccccccccccccccccccccccccccccccccccccccccccccccccccccccccccccccccccccccccccccccccccccccccccccccccccccccccccca
accccccccccccccccccccccccccccccaccccccccccccccccccccccccccccccccccccccccccccccccccccccccccccccccccccccccccccccccccccccccccccccccccccccccccccccccaaccca
acccccccccccccccccaccccccaaacccacccccccccaacccccccccccccccccccccccccccccccccccccccccccccccccccccccccccccccccccccccccccccccccccccccccccccccccccccaaccca
aaaccccccccccccccccacccccaaaccacccaacccccaacccccccccccccccccccccccccccccccccccccccccccccccccccccccccccccccccccccccccccccccccccccccccccccccccaaccaaccca
aaaccccccccccccccccacccccccccaaccccccccccaacaaccccccaccacccccccccccccccccccccccccccccccccccccccccccccccccccccccccccccccccccccccccccccccccccccccaaaaaaa
aaacccccccccccccccccaaaccccccaacccccccccccccaaccccccaccaaaccccccccccccccccccccccccccccccccccccccccccccccccccccccccccccccccaccccccccccccccccccccaaaaaaa
aaaaacccccccccccccccaaccccccccccccccccccccccccccccccccccccccccccccccccccccccccccccccccccccccccccccccccccccccccccccccccccaacccccccccccccccccccccaaaaaaa
acccccccccaaacccccccccaaccccccccccccccccccccccccccccccccccccccccccccccccccccccccccccccccccccccccccccccccccccccccccccccaacccccccccacccccccccccccaaaaaaa
aaaaaaaaaaccccaaccccccccccccccccccccacccccccacccccccccccccccccccccccccccccccccccccccccccccccccccccccccccccccccccccccccaacccccccccaccccccccccccccaaaaca
aaaaaaacaaccccaaaaccccccccccccccccccccccccccacccccccccccccccccccccccccccccccccccccccccccccccccccccccccccccccccccccccccccccccccccccccccccccccccccaacaca
aaaaaaacccccccccaacaaccccccccccccccccccccccccccccccccccccccccccccccaaaaaaaaaaaacccccccaaaacaaaaaaccccccccccccccccccccccccccccccccccccccaacaccccccccaca
aaaaaaacccccccccccccccccaaaaaaccccccccccccacccccccccccccccaaaaaaaccaaaaaaaaaaaacccccccaaaacaaaaaaacccccccccccaaaccccccccccccaaaaaacccccaacccccccaaaaca
aaaaaaaaaaaaaacccaaaaaccaaaaaacaaaaaccccccaccccaaaaacccaacccccaaaccccccccccccacaaaccccaaaccccaaaaacccccccccccaaaccccccccccccaaaaaacccaccccccccaaaaaaca
aaaaaaaaaaaaaaaaaaaaaaaaaaaaaaaaaaaaaaaaaaaaaaaaaaaaaaaaaaaaaaaaaaaaaaaaaaaaaaaaaaaaaaaaaaaaaaaaaaaaaaaaaaaaaaaaaaaaaaaaaaaaaaaaaaaaaaaaaaaaaaaaaaaaaa
"}
